    LOL!!!   Throwing the BULLSHIT Flag on such nonsense!!  #PutUpOrShutUp   #Kavanaugh   #MAGA   #CallTheVoteAlready URL	OFF
  You are correct.	NOT
   She?  To whom are you referring to?  Hillary?  You know what is tiresome?  Bernie supporters bashing Hillary Clinton.  She is an actual Democrat who raises money for the Democratic Party and doesn‚Äôt bash them.  She has a positive message.  So who is dividing the left?	OFF
   Any updates re ending your blatant #racism as #Windrush &amp; #Grenfell proves you are    #alloutpolitics #politicslive #PMQs  URL	NOT
 Blow hard	NOT
     Socialists politics that stand up for the downtrodden. And well done for conflating criticism of Israel with anti semitism. You are also part of the problem.	NOT
 Lol yeah per dina he is There everyday per claudia no horse got vet care unless it was for donation example limping etc	NOT
   What a surprise.... same as antifa. BLM and so on and so on. Soros is Americas worst enemy in HISTORY. He believes the only way to take down the USA is from withing. And hes right. But it's not gunna happen.	NOT
   URL any of your announcements every come to fruition or is it basically stealing Labour's ideas to get a few more votes	NOT
"  The prison system is so fucked.  Why are they still getting away with what is potentially murder with intent if the prisoners die in the hurricane? They did this in Louisiana and like 500 inmates went missing"""""	OFF
 ur so straight forword manüëå i saw u in dance dewwane and ur just talk free ky ap kitnay porrany ho industry mein and i really like ur this quality that u even gather with ur seniorüíö artist love for #Manmarziyaan ü§†üëç	NOT
 She is drinking so much koolaid she‚Äôs bloated.	OFF
 Let's get to the bottom of this! DM me your zipcode and I'll check it out.  We have your back and we will make sure you are enjoying the BEST that TV has to offer ASAP! *NevinBruce	NOT
   please don't kill me. antifa on the other hand...	OFF
 Did you see Shanahan say Spoon was not 100% healthy this game? Obviously no excuses if you‚Äôre out there BUT maybe it‚Äôs not the ‚Äúall is doom‚Äù sort of thing it seemed during the game. Maybe he is still pretty good.	NOT
  We have been saved from you! MAGA!	OFF
 Do you think Canadian liberals will actually blame Trudeau if he costs them this? Or as per standard push it off on us?	NOT
   Why can't liberals read??????  READ it AGAIN URL	NOT
I added a video to a  playlist URL Combat mon frere vs Ismael et Maga assassin vs David le boxer (YFC 2)	NOT
 Absolutely should be a nail in the coffin.... for Hilliary	OFF
  I hope he gets on twitter so I can tell him how amazing he is. ‚ù§üòÑ	NOT
 He is a DUMBASS !!!!!	OFF
 the owner of my culo	OFF
  Leftists showing yet again how vile they can be	OFF
Shouldn't pussy grabbing  be the one wearing the gloves while handling food? #MAGA URL	OFF
 You have no plan for the environment. Even conservatives should be able to understand that you have to be able to live on the planet to make money there.	NOT
   There all gone tho and Inputed them from bottom to top with the first 20seconds of your tweet ! You good 1 Tmart üëçüèª	NOT
 I‚Äôm sure he is. üíú	NOT
  Melting snow flakes	NOT
 Who‚Äôs the victim? That remains to be seen. Liberals have turned Kavanaughs hearings into a circus from the first minute it started.	NOT
  You're shocked to hear that liberals want to centralize power at the federal level?	NOT
   Liberals can‚Äôt meme. They have no sense of humor or knowledge of meme-ing philosophy.	NOT
        Trash	NOT
 Thank goodness he is not MN passive aggressive. Love it!!	NOT
 If bobby is fit thats exactly what i would say but not sure if he is or not	NOT
 What the fuck game are you watching?	OFF
   don‚Äôt perpetuate colonialism. If you are going to talk about #puertorico you must have Puerto Ricans in the panel! Jeezuz.fucking.christ! How difficult can that be? #di√°sporaenresistencia URL	NOT
 Yes I saw this and I will say tapper kept basket her and she kept coming back with stupid answers And he finally gave up I don‚Äôt think he is a big fan of her policies he‚Äôs not that stupid please	OFF
 Are you joining ANTIFA?	NOT
  Apparently durbin has amnesia	NOT
5/5 Canada has regulated firearms since the last quarter of the 19th century. Those laws have probably contributed to Canada having only 1% as many handguns in circulation as in the US.  URL	NOT
    Interesting when Demoncraps aren't even inventive enough to create their own cartoons.  This is originally put out by Republicans - liberals are the Koolaide drinkers and always have been. Liberals are also the scum of the earth and prove it daily through their lies	OFF
   I don't think you have a clue what leadership and liberals have the temperament of 2 year old children being told no....you have the intellectual brilliance of a goat.. please stop tweeting. TDS  is making look quite the fool..	NOT
                Rich you are my OG follower..i had 2 311 fans follow me first but they have hardly ever tweeted..so u get the honors	NOT
   i think i missed a few replies here (im on a conference call) but most of the anti jihadi muslim vets i know would disagree with gun control. so this seems odd...?	OFF
 You can't lump small l Liberal conservatives in with the far right nutbags.......	NOT
 Liberal MP Leona Alleslev‚Äôs decision to cross the floor &amp; join the Conservatives would seem to be a betrayal of her supporters. Did she consult those who voted her in? Seemingly it‚Äôs legal? Imagine if #DougFord decided to cross the floor &amp; become the Liberal Premier. ü§î üòÇ	NOT
 Get another disgrace.	NOT
 YESSSSSHHHHH who else call you shitgull if it were not me or ryme üòö	OFF
  Poor sad liberals. No hope for them.	OFF
" ATTENTION!  is publicizing an ANTIFA TARGET  list comprised of Trump Supporters' names. Some are high profile names and MANY are random everyday Trump supporters. Twitter has NOT suspended his account. Check out his Lists""."""	NOT
 ‚ÄúYes you are.. ‚Äù	NOT
".   What say you now?  I guess it's ‚úåÔ∏èfor liberals to use the so called white power"" gesture.  URL"	NOT
                                                 Hahaha by telling me to stfu?  So hurt ü§£	NOT
   The tourist on holiday with his parents place a sticker on a pole in Turkey while his parents ate a restaurant and you call that support	NOT
   I don't think he is	NOT
  when robyn posts a selfie the world stops for a moment to appreciate it	OFF
 ROMY OMFG IM SOOO GLAD I MET YOU TOO BFF FOR LIFE ! YOU ARE THE BEST I LOVE TALKING TO YOU	NOT
"  She's right, she's not one of,"" she is ""the one and only."""""	NOT
"       For example, I don't think that liberal imposition or inauthenticity"" is the issue here. The issue is that of borders and citizenship - liberals assume the same rights and equalities arguments apply across borders that apply within borders. But that is not a widely shared view."""	NOT
          So absurd.  The left has been fielding violent feminists and communists in the form of Antifa to attack the very peaceful transition of power for more than two years.    I wonder if it will ever occur to you that you are the bad guys?  I doubt you have the moral fortitude.	OFF
     No it's genetic.   Being racial isn't racist  This was co opted by the liberals and twisted into something it's not.   The actual definition of racism is thinking one race is better or inferior to another race    So (looking out for your own race) doesn't meet the definition	NOT
    Seriously üòÇ no word of a lie though I am all done with live feeds after she is evicted. I cannot handle another second of all the other houseguests	NOT
 She mocked SJWs and the KKK with extremely clever satire. The fact you don‚Äôt have a sense of humor or are too stupid to get it is our fault. None of that means you get to denigrate or lie about her or her motives. She is a Native American woman and you are a bigoted misogynist.	OFF
 You are not alone.   I am here with you.   Razzinfrazzinmaggle	NOT
. talks books + she is giving away a copy of her new book  #writerwednesday URL	NOT
  The fact he committed perjury in confirmation hearings should have got him booted out by now. Unfortunately the GOP seems to think it is OK to lie if you are on their team.	NOT
   it‚Äôs too bad california doesn‚Äôt have any common sense gun control laws that prevent criminals from doing illegal things.	NOT
 you are so beautiful	NOT
  Just want you to look at her face the bright enthusiastic happy person she is !	NOT
 Good!!! This will surely show us how croocked he is. üòÇüòÇüòÇ	OFF
 Animal Mother!  You are the man! URL	NOT
       Exactly Hat   are true Feckers ! I detest them	OFF
    Oh boo you sound so ignorant with your words. We are on Top. All of America is on Top now. How about stop resisting and try to help make our nation the best for everyone not just liberals. Wake up and Walk Away.	OFF
 Everyone should vote regardless of the candidates and parties they support.	NOT
  SOME THINGS NEVER CHANGE! In 1991 #SCOTUS Clarence Thomas‚Äôs #HighTechLynching by   &amp;   #MAGA FIGHT BACK against these lies! #ConfirmKavanaugh      #DJT  #Kavanaugh #MeToo  URL	OFF
 When are the Republicans going to learn that Democrats hate conservatives .Vote  Thursday	OFF
 It's a political hit job gleefully pushed by #FakeNews   and their puppet little Jimmy  Liberals always finding new lows!!!	NOT
 The off and on gun control debate starts again.	NOT
  Maybe he is making amends before #OpenSelection passes at conference.	NOT
 If they admitted they are lead by and  cater to sex criminals exclusively it would be harder to condemn liberals and leftists as degenerate deviant cultural marxists	NOT
 Either way #NY is screwed!!!!!	NOT
 I quite enjoy these tweets you are liking	NOT
(Good for you Gov) Gov. Cuomo gets endorsement of nation's largest gun control group: URL              	NOT
     She is going to be heartbroken to see you and you 6 followers go. Bot bot bot.	NOT
 PLELLEEAAAASEEEEE I LITERALLY SOBBED SO HARD AT THIS SCREEN WHO DOES HE THINK HE IS LOOKING SO BEAUTIFUL WHILE HE SLEEEEEEEPS	NOT
#sorrynotsorry   If you breastfeed your child who ends up having a milk allergy and so you just SWITCH to formula are you really putting your 100% into parenting?! No you are being lazy! Change your diet go lactose and soy free so your baby can have the best of the best.	NOT
 Yep this is the world the liberals want to live in.	NOT
  LMAO....YOU SUCK NFL	OFF
#YESonKavanaugh Yes because it is the right thing to do Yes because conservatives are in power Yes because Democrats are miserable humans Yes because we are sick and tired of the tantrums from the Democrats Yes because they FREAKING LOST THE ELECTION! Please add more reasons!!!!	OFF
" HAHAHAHAHAHAHAHA!!! She may need to change her strategy. Acting like a spoiled child... throwing a tantrum and showing the world what a sore loser she is... on national television... isn't a great way to improve how anyone"" is viewed."""	OFF
    To be fair. I‚Äôm positive most liberals are just blobs of cells..	OFF
 Best not stray off message. We need to be using every death to blame guns and push for gun control. Talking about actual causes distracts from that. üôâ #gunsense	NOT
  It‚Äôs laughable that you parade China with its shocking human rights record. In China extreme Gun Control only meant death for millions of Chinese citizens at the hands of the state ... The History is well known.	NOT
#Liberals grasp at unproven straws ... #NotPlastic URL	OFF
 I hope they were Reporting on Gun Control	NOT
 How fucking sad üò£	OFF
 I suppose you think the way liberals attacked Sarah Palin was courageous also. You‚Äôre just another hypocrite.	OFF
  Ilegal Invader Kills 13-Year-Old Canadian Girl	NOT
  WTF was that other than a waste of a minute and change of my life	NOT
 you are not alone/ I am here with youüé∂ üòÖ	NOT
 Always looking for faults and forgetting to look at the whole picture.  Journalism (objective reporting) is dead as now everyone is a pundit (subjective expert).	NOT
  So... what did The Big O accomplish on gun control in his 8 year disaster??	NOT
"  Aurora is growing and learning stuff quickly! She is really good at drawing and counting! Such a intelligent baby ~ ""  He laughts playfully at kiss being breaked. Pecks his nose."""	NOT
 She is better than everyone at everything because she is a literal angel who can do no wrong	NOT
  then you are not equipped to adopt. period	NOT
I think Judge Kavanaugh will be voted through next week after Mondays hearing unfortunately for him his reputation has tarnished by these vicious lies MAGA WWGIWGA URL	NOT
 Beto also wants open borders so illegals can come an go as they please an also more gun control espically on semiautomatic weapons...#BetoNotForTexas	OFF
 He needs to lose some weight	NOT
 Corrupt period...üòÜüòÜüòÜüëäüèΩüëäüèΩlast week u liberals were saying he won‚Äôt release bc he has something to hide üòÜüòÜüòÜüòÜüòÜ o boy u pple those pple  that depend on an actor for info Wow! U pple scare me is it green today or is it yellow üòÇ‚ÅâÔ∏è	NOT
 happy birthday dad ily thanks for being the best man you can be and for caring for all of us. we love you and appreciate all that you are and all that you do üê®üêª	NOT
"  That solidarity with Israel"" banner photo of ""Antideutsch"" infiltrators was originally used in an online mag Bunker which has connections to fashy pro-≈Ωi≈æek types from the 8chan /leftypol/ board. It's a go-to image for the ""anti-antifa"" crowd. Archived: URL"	NOT
 Blame Trump for the weather and the corruption that existed for decades in PR. What an ass typical democratic	OFF
 Won't be legalized federally since it can be used as back door gun control.	NOT
     Thanks DBC! Love reading your books! I‚Äôve heard that #51 is pretty epic too - looking forward to *finally* getting to read it soon!!!	NOT
I did not know this.  Great job #california !  #MAGA URL	NOT
 GGG knows he is going to knock him out no way this goes to judges.	NOT
 i had a man tell me their body count was 40+ but refused to be with a woman who had more than 5. what the FUCK.	OFF
   Have you all seen this from Antifa about disarming people in open carry states? URL	NOT
 Exactly! Ford is just a damn pawn for the Baby-Adults of America / aka Democrats. #SheIsALiar ü§•- I ‚ù§Ô∏è that Conservatives will control the highest court for 20+ years.	NOT
 Love ya girl!! Never change!! Your perfect as you are!üôãüåπüíã	NOT
 Sex is work	NOT
   50 Year Mandatory Federal Sentence for ANY crime committed with a gun. Stop the gun control nonsense and punish the guilty ! NO politician today will support this !! Gun control and safe zones DON'T work. Pols don't want less crime only Hot Air !!   URL	NOT
" The pit bull debate is just like gun control. Pit bull kills someone and here comes pictures here's my loving pit."" gun kill's someone and its ""I have 4 guns and they never killed anyone."""""	NOT
 sis Mandys no nose havin ass from the grim adventures of billy and Mandy can smell that shit wheeew URL	OFF
 Dividing us is no longer working for hollyweird Demoncraps or liberals #race card no longer helping youü§ê‚ùÑÔ∏èü§•ü§¢üòà	NOT
   You bring up a great point. These morons really look at life like it's the movies. They do it in the gun control debate all the time. They seriously think that a shootout with a bad guy will never hurt bystanders. It's why they want to arm teachers. Idiots!	OFF
 but nice	NOT
" Step 1: Approach the fascist from behind.""  I see two problems with this, the first being that it would require the antifa member to recognize their own projection."""	NOT
 It all makes sense now that‚Äôs why he is wondering around omg I was thinking why is he becoming so local he needs to head back and make that album I am stressing	NOT
#obama: wall won‚Äôt keep terrorists away. Same Obama: gun control will prevent killings by criminals (and terrorists?) #WalkAway	OFF
 republicans /conservatives are the most disgusting people	OFF
  The more Antifa BS average Americans see in the news the more repulsed they are by their antics.	OFF
.        We did a great job of electing  and a terrible job of who we sent to congress to support him   Conservatives left frustrated as Congress passes big spending bills URL	NOT
"&gt;500 comments, and all negative, slamming Chris Hayes for promoting vote suppression via Michael I love rapist &amp; Putin-puppet Assange"" Moore &amp; his latest ""kill the Dems"" movie. How about a town hall on women's repro rights &amp; gun control on eve of Kavanaugh vote instead? URL"	OFF
 I don‚Äôt know who she is but she don‚Äôt  sound too hot in the video lol	NOT
 There you are! üëãüêæ	NOT
"REPORT: Christine Blasey Ford ‚Äòprepared to testify‚Äô ‚Äî but there are some catches""  URL #TCOT #MAGA #RedNationRising"""	NOT
  He is a Russian troll. Look at the rest of his page.	NOT
  She is attempting to emotionally manipulate Canadians  Standard behaviour for the Trudeau ‚ÄúLiberals‚Äù.	NOT
 Thats is not what i was saying.. read my other tweet to you.  I never said that.. you sir are putting words in my mouth!  liberals really are just assholes.. cant have a civil discussion!	OFF
" Lol Religion of peace"" am I right fellow classical liberals? Izlam totes needs a Reformation"""	NOT
    Becca. She is too much work.	NOT
 No one is open! You think he is sitting there waiting to get hit lol. The pick that was called back Kyle said the one of the receiver ran the wrong route again! A route that was need to pick Matt open! ü§¶üèΩ‚Äç‚ôÇÔ∏è 49ers need to get their head out of their asses	OFF
  More Jewish theatrics from (((Google)))	NOT
 And Twitter seems to be beholden to CNN	NOT
 As a member of antifa? ;)	NOT
     So tell me all about why you are simply rudeand racist. Was it your mother‚Ä¶?	OFF
 polls pls	NOT
 Cali already has some of the most strict gun control laws in the county. And you can't blame this on on Indiana.	OFF
 Double down on rating. Bet NCAA loves this.	NOT
 Wayne say he trying out do drake so this shit gotta be decent at least!	OFF
 Are you and your family okay? Not sure how close you are to everything.	NOT
" So funny, this was labeled as sensitive media""!!   Yet, people post porn on Twitter all the time. Unfiltered"""	OFF
  He's a crook #TrumpTime URL	OFF
" Gun control measures?  As in Fast and Furious"", where you directed FFL dealers to violate the law and allow straw purchases?  Where you knowingly allowed firearms to be sold to criminal organizations?"""	OFF
  What? I have no clue what you are trying to say. I‚Äôm certainly no Trump supporter FFS. Just rational üòÇ  Keep on keeping on with whatever it is you are trying to achieve.	NOT
 I think that some might be wearing nasks and carruing Antifa flags	NOT
 Flake is a perfect name for this weirdo!	OFF
 A disgrace	NOT
" The only thing the principled"" conservatives are outraged about is the clear moral and intellectual need for diversity and inclusion of all people of all faiths.  "	NOT
 Do you also wanna do some photography over the weekend? I‚Äôm bringing my camera gear!	NOT
Louisiana Attorney General Jeff Landry encourages Attorney General #JeffSessions to break up #BigTech companies like #Google and #Facebook  Nothing is going to happen until we get a new AG in November!  #MAGA URL	NOT
 Well iWas cool my girl don‚Äôt like shit popping out at her so it scared her a little when shit popped out	OFF
" You act like that won't be fun for both of us.""  She contemplates getting down, he's been gone for a few minutes and she's just standing on a chair like a weirdo.   Just as she is about to get down she sees him walk through the door.   ""Technically I only thought about it."""""	NOT
EVERYONE HAS TO VOTE RED SO WE DON'T LOSE THE HOUSE IN THE MIDTERMS üá∫üá∏ IF WE LOSE THE HOUSE IT'S ALL OVER!!!! THE MAGA MOVEMENT WILL BE FINISHED!!!! MAKE SURE EVERYONE YOU KNOW IS REGISTERED TO VOTE RED!!!! GET OUT AND VOTE RED!!!! MAGA!!!! KAG!!!!   #WALKAWAYFROMDEMOCRATS URL	NOT
 Thanks to all the bleeding heart liberals who would rather pay for illegal immigrants then people who are battling cancer.	NOT
 This shit gon keep me in the crib lol fuck it	OFF
. is no champion for women. URL	NOT
 And the most insignificant comment comes from a Miss America contestant.	NOT
 Heck yeah. And also she IS cool	NOT
 That shit weird! Lol	OFF
 Omfg yassssss! üòç	NOT
 All you need to know about the importance of the midterms	NOT
 Antisemitism is alive and well in the UK!	NOT
 When you are playing inside you don‚Äôt get beat inside. I agree not a major mistake.  I‚Äôm glad you found it because I was questioning my mind again.	NOT
 The #metoo movement has turned out just the way black lives matter and Antifa turned out. Started out as a worthy cause and then ruined by a bunch of bandwagonists. More harm than good.	NOT
  Yep. Here she is defying us to take another picture. URL	NOT
 That one sucks bc he is so hit or miss	OFF
  says social housing is good and in the same breath talks of climbing the ladder.   Hypocrisy incarnate from a failed lying politician lining her party's pockets with tax money for real estate builders  building their failure of lies	OFF
  The gauge potential is the connection on the quantum field as like in differential geometry. and the field strength  tensor is the curvature tensor.	NOT
 He will get what he deserves in the Mens prison........	NOT
  She is known to be sneakyüò°	NOT
    So you are ok with the racial epithats that the left calls black conservatives? #bigotry #hypocrisy #walkaway I did. Many have. Dont be blind. You are being a tool for a establishment. Keep resisting the outsider and be for the political elite millionaires.	OFF
 Bring back Alex ... Jack... or Ban NYT too...	NOT
" Shit like this is why I don't follow   Who me? I'm just stating basic facts.  Totally NOT diverting from the actual point. Just stating a fact.""  You're a phony"""	OFF
 is the brainchild of  - He is playing dirty against  and Jen is using her ill gotten money against  Mailer linking Nixon to anti-Semitism was approved by top Cuomo aides URL	OFF
 As usual a seemingly and supposed smart feminist thinks she has made sense.. Yen yen yen yen yen yen alone... You just told me rn you are also dealing with another person.. Have you considered maybe you are the toxic one?	OFF
  Liberals are the worst sexists.  Not all women speak truth especially political activists.  Try judging the veracity of the allegation by evidence instead of gender.	OFF
    LMAO! You are still butt hurt that your loser Hitlary lost. Love it. See you at the polls in 2020 Bucky.	OFF
  What an incredibly odd little man he is.	NOT
  Williams displayed her bad tempered side to the world and it is something she will probably always regret. I would say to her be ye never so high that you believe you are above the rules.	OFF
 Fear monger. Fake rage.	NOT
 I‚Äôm finna say fuck it and get a crispy ass jogging suitüòÇüòÇ	OFF
Adulting is knowing who fucked cut off in your future plans.....	OFF
   Stop giving me quotes start giving me facts that prove gun control will work	NOT
  I'll answer for You!!  when you have a different opinion to them you're a racist...when they lose an argument you're a racist...if you love Britain you're a racist...liberals are week people...it takes a strong person to to not be one of the sheep	OFF
  Apparently conservatives are now automatically guilty of any crime or assault that shows up from no where at the last possible minute. We are no longer presumed innocent until proven otherwise.	NOT
    Can you imagine what she is like to waitstaff who get her order wrong?	NOT
 Happy dance that Serena lost. She needed taken down a notch or two.	NOT
  Can't do that. BLM and Antifa morons will start looting	NOT
  ok with Andrew  Bully Liar touchy cheat to be kept on as a MP? On ¬£75k? No anti bullying rules? URL ‚Ä¶    	NOT
   Are you aware that Hillary Clinton said she was going to use Nuclear weapons against Russia. That was after she sold the 20% of our weapons fuel. She is a complete idiot.	OFF
 Dianne Feinstein disagrees. She effectively called the woman a liar	NOT
 Georgia University...your racism and utter lack of tolerance is showing. Higher education is apparently not your goal.	OFF
 This is another attempt from the Democratic liberals to bash a judge this didn't come out any other time and since it's many years ago she should have to prove it and I still think they should have that vote also there a Democrat running for mayor and he paid his girlfriend	NOT
   Because some people are bastards. You're hopelessly na√Øve if you think plenty of frauds won't take advantage of this law change for malign purposes.	OFF
 Crazy liberals	OFF
 You‚Äôre right. But if our terrorize someone for having a different belief.. you are not any better	NOT
    Lisa Page confirmed the Russia story was passed to the MSM as a distraction for gullible liberals to push as a narrative to hinder our duly elected president‚Äôs success in office.	OFF
                                                 pretty much spot on there	NOT
 The reason people are tired of this is because you only focus on the conservatives. Ford has treated people poorly and the constitutional crisis is abominable. His treatment of the women in the legislature is despicable.	NOT
  Conservatives historically go by the constitution . Part of the reason for the name . The libs like to make to make it up as we progess(ive)	NOT
 That's a strange question to ask me because of course I love my sister!! I'm her big brother! I'm there to make sure she is safe and alive!	NOT
#TuesdayThought.   The only hate speech that I hear these last 2 years is from Liberals- STOP THE HATE!	OFF
 Hes sure as hell not one of is either... traitor liberals- all of them-	OFF
Trump‚Äôs border wall will never happen. #MAGA #BlueWave2018 URL	NOT
"    Then your statement that Conservatives/GOP hold to the higher moral ground and they know that sex scandals bother us"" is hypocritical.  Both sides are equally guilty and should be held accountable regardless of party."""	NOT
 Yet more evidence that the  have turned ‚ÄòThe Party of Business‚Äô into ‚ÄòThe Party of Fuck Business‚Äô. Bizarre.	NOT
   He is a wonder dog he could have a couple doggie girlfriends	OFF
     He is Harry Potter	NOT
 It also goes to show that all those so called news people that laughed at you are now eating crow. How wonderful it is to watch the looney liberals squirm around like worms drowning in sunshine.	OFF
"       üòÇüòÇüòÇüòÇ whatever. It was more than enough for 'Antifa &amp; the rest to stay home! Peaceful. Dignified. On Point. Last time the left did that???????? I'll wait"""	NOT
 Pat Shurmer scored 7 points against the eagles in playoffs last year and only 22 at home vs saints until miracle play he is not a great offensive coach.	NOT
 Ok give it up u low life conservatives move on u got one year til election for canadians to show u that WE DON'T WANT RACIST RUNNING R COUNTRY so grow up and let's talk about how u dont like anybody who dont look like u	OFF
" &gt;unfuckable""  where is the truth in this statement, all i see are lies"""	NOT
"   Bret, maybe you're just running away because you pretended to be an expert and got pounded into submission by a girl.  All you did was assume and demand proof, I provided. You provided 'your say so. In terms of debating, you lost. Have a nice day."""	OFF
 Most likely gang related violence with a illegal gun in the most strict gun control cities .	NOT
   You can compare any two countries you like and you‚Äôll always find the one with stricter gun control has a lower murder rate with no pattern in democratic freedoms.	NOT
.  continues our look into government spending. Part II is focused on funding announcements made in battleground Quebec over the summer #cdnpoli URL	NOT
   Lmao you are the only who are getting so brave üíÄ stay pressed trashno neptune	NOT
    its fake? its from 2 different maps guys	NOT
  Carlson showed us exactly who he is - a slimeball Fox representative. Fox watchers who love his views ate it up. Normal intelligent people were disgusted by his tactics.  Loved that Avenatti laughed in his face.	NOT
All of this shows just how scared Liberals are of the New  that is going to be guided by the Constitution &amp; Bill of Rights. They honestly believed they had made them powerless in today's courts.  Trump is #MAGA &amp; Deplorables are helping. URL	OFF
  Typical... When it backfires it's nothing to see here move along...  Trump supporters these days are doing the same thing... All this shit Trump is getting called out on. It's nothing to see here move along . Lol	OFF
    Yet they haven't. How do you know they are actually antifa members and not far right pretending to be violent antifa to make people like you think they are so dangerous.   ü§î Hmm	NOT
13 teachers and students blasted in Wisconsin with 12-gauge Winchester 1300 pump-action shotgun. The NRA blames gun control laws.	NOT
 #maga baby!!	NOT
 big if true	NOT
 please draw stupid sexy nezha and nidus over the shoulder or something.	OFF
   No. She is a liar.	OFF
"  I would temporarily change parties if the Republican party would Primary agent orange"" with a REAL, Republican, Conservative. That would MAGA!!! At least a great start."""	NOT
56 million defenseless people were rounded up and exterminated in the 20th Century because  of gun control.	NOT
 He‚Äôs talking as though Pres. Trump if failing at every turn. Actuality is totally opposite. Get a grip you fool!	OFF
"            That and racist!"" Imagine if it was a black woman that accused him of the same. I should probably keep that to myself because i can see some Dems seeing this somehow and thinking ""how can we make this even worse on Kavenaugh? Got it!"""""	NOT
 Yeah! You can‚Äôt just wing cooking!   There‚Äôs all kinds of measurements you need to follow otherwise it‚Äôll end up tasting like garbage.	OFF
 Everyone who is against this is called a ‚ÄûNazi‚Äú by Antifa scum and politicians.	OFF
" You know what will make this professor even woker""? If he's a gun control nut...."""	OFF
 Omg yessss!	NOT
 But she is hecking cute fluffer	NOT
  He needs more ‚Äúgun control!‚Äù üòÇ	NOT
    Great connection!!!	NOT
  He is here. Every one on council is here.	NOT
 You are not pretty üòò	NOT
"...those who stayed put over the past 12 months-according 2 the Federal Reserve Bank of Atlanta."" #MAGA"""	NOT
 She is perfect in every way!!!	NOT
 üòÇüòÇüòÇ You are the wife URL	NOT
 She is sooooo pretty!!!!!	NOT
 And sadly Anna decent fair minded One Nation Conservatives like you seem to be an endangered species in your Party. How can Tory grass roots support a man with Boris Johnson‚Äôs record on morality and standards? Or a caricature like Mogg?	NOT
  The petty semantics regarding ANTIFA. You Are better then that.	NOT
  Just block the idiot. He's not even worth this post.	OFF
 Nah Antifa are good to get killed	OFF
      2/The Democratic Party won‚Äôt do anything to him because he‚Äôs Muslim Brotherhood &amp; they don‚Äôt care about Monahan.  The Muslim Brotherhood needs to be declared a terrorist organization‚Äîall of it! Ellison also supports ANTIFA. These people are so foul it‚Äôs scary!	OFF
 So. Gut. &lt;3 &lt;3 &lt;3 &lt;3	NOT
 What do you do when you are bored? #AskAlly	NOT
 Doubt he is losing much sleep over it. The guy has been a busted flush for 30 years	OFF
 Another turd gone from ESPN. Maybe one day we can watch sports on the channel	NOT
 Epic fail on that front.  Hopefully she will succeed in the future.	NOT
  Talk about the pot calling the kettle black... You should be ashamed of your cash payoffs to Iran &amp; of you helping Iran to become a necular power. It would be better if you just set your sales and gave us all a big wave goodby.  will clean up your mess. URL	OFF
  Wassamatta? Starting to wet your pants? Worried about all your dirty deeds coming out? Concerned about not getting a view cell at #GITMO?  #MAGA  #KAG2020  #DrainTheDeepState  #WalkAwayDemocrats2018  #LiberalismIsAMentalDisease	OFF
 Exactly so shut up	OFF
 I‚Äôm praying he is caught in every illegal activity that he‚Äôs involved in! He has a very explosive anger issue! He‚Äôs like a child that throws a dangerous tantrum when someone doesn‚Äôt agree with him. I wonder how he treats women?	NOT
 Clinton‚Äôs will get u	NOT
 have you ever served this country other than be elected? Because that is not the same!  Have you ever put your life on the line for others?!  I am one of the Dregs Of Society! #DregsOfSociety üá∫üá∏#MAGA	NOT
 B.S. How much fake data has big pharma fed you. You are penalizing adults who vaping has helped. You have a far bigger problem with teen alcohol sales and flavored wine coolers. Try reading a legit study.  URL	NOT
   Great. Here‚Äôs how today has gone: Floris wanted to spank me. Leah wanted to stab me. Curtis won‚Äôt back me up. Adam still looks great at 67 or however old as fuck he is... KL has a bigger dick than me but she‚Äôs a she...heü§î...she?!? URL	OFF
  Most Americans find any of this hard to believe...30 plus yrs later.  Another Justice Thomas hit job by the media and liberals?	NOT
 I just think that he's more likely to be lying about this to protect himself than she is lying just to disrupt her life for no apparent reason. I've also known entitled men like him.	NOT
 Just PM you the 1st part of the debate for Sunday on Gun Control &amp; the 2nd adm	NOT
  Are you kidding me? I‚Äôm so pissed for you. He is a sorry excuse for a human being.	NOT
 This is like when shitty restaurants advertise their ‚Äúvoted #1 world famous crabcakes‚Äù but nobody can tell you who voted and nobody who lives outside a 10-mile radius has ever actually eaten there.	OFF
   Can you let him know?	NOT
 u said marriage is just a title.....if u knew u had money to protect u wouldn‚Äôt see it that way that‚Äôs why i said that. but if u ain‚Äôt broke then that statement doesn‚Äôt include u mista bill gates	NOT
 Hint Call 1 800THEWHITEHOUSE	NOT
"  Maybe I'm wrong, but didn't you take an oath to preserve and uphold the constitution?   Take your people control (it's not gun control) and gtfo with your crazy.   Steve Willeford says hi"". Don't know the name? Perhaps Google it and realize how stupid you are."""	OFF
 lemme rap on that shit. I'll do a video floatin downstream in a coffin like in horrorland lol	OFF
 Nobody is addressing the cow in the room. Not even when Florence is still doing her thing. It's like after a mass shooting and it's the wrong time to talk about gun control. 	OFF
 White Nationalist and Nazis arent the same. Also at this point I'd prefer nazis tbh	NOT
  Thank u..	NOT
    What I  saw him do in TC show was nothing short of amazing!  He is willing to take the fight to them &amp; not allow them over power the conversation.  That's why TC said SLOW DOWN!!	NOT
    is not a difficult woman she is a far left leaning bitch. She has no place in unbiased commentary on any platform. Get rid of her.	OFF
  The point being made is that the support comes from the right of the party - it‚Äôs relevant because it gives clarity to the offering made to the good people of London - they now know a  vote is like voting for Marine Le Pen. You‚Äôre welcome.	NOT
 Liberals live in fantasy land. URL	NOT
 If he survived he obviously doesnt know anything about gun control. Are we sure he is a lib?	NOT
     Chicago has strict gun control laws but the highest gun violence rate Detroit was owened by Unions and is now bankrupt Cali has the second highest welfare rate and is now the homeless capital of the developed world.	OFF
 Beto-I‚Äôm100%FundedByNYandHollywoodLeftistsButPretendingToBeATexan-O‚ÄôRourke. #KeepTexasRed	NOT
  Man I‚Äôm glad I can make y‚Äôall‚Äôs day. I just be saying stupid shit on the fly. I ain‚Äôt trying I‚Äôm just dumb lmao URL	OFF
 This is ridiculous...UNBELIEVABLE !!! So this fine young man is now dead because of a stupid reason .... come on !!!!! Gun control is the solution y'all so many innocent people got killed because of gunsüò°üò°üò° This has to stop	OFF
 do you have any other recourse? This is so wrong on so many levels. Can you sue them? I wish there was a way to reinforce your points on the mistreatment you have received. Liberals are full of hate and discontent and unfortunately there are more of them than us. Idiots. URL	OFF
 But they‚Äôre still the number one Fake News Network.	OFF
"...The book makes Trump look good &amp; makes the so-called Deep State"" - 'particularly Mueller - look like a pack of partisan hacks.'  Woodward Book Proves 1 Thing, Liberals Fear Trump Isn&amp;#8217;t Breaking, the Deep State Is URL"	NOT
 shut the fuck upppp kliff i'm bigger than you and gayer than you so don't try any shit	OFF
20 more votes for #Democrats &amp; let's see... How many murders of #Conservatives #justsaying URL	OFF
 btw haven't heard about ANTIFA lately since Soros ran off without paying them after their violent riots across the US	NOT
 I think it‚Äôs a stupid choice not to put the planting of the flag in there.  You are intentionally saying FU when you could be having audiences clap and cheer because of the accomplishment of the nasa team and the country‚Äôs support.  Not going to see it.	NOT
 Antifa has never attacked voters by the way. That‚Äôs a full on lie. You have the informational diet of thinking cotton candy is a vegetable. You might want to reflect on that.	NOT
 I just read that whole thread and that guys thinks he is a boxing media social media sure have mess up some ppls  head ü§£ü§£ü§£ü§£ü§£ü§£ü§£ü§£	OFF
 ball is in our court not yours	OFF
   I will never forget what levels you racist liberals went to and what you did to Clarence Thomas. Liberals are  the worst people ever.	OFF
  TWO YEARS TO HAND HER HOMEWORK IN......AND ITS STILL LAST MINUTE AND UNPREPARED.  PARTY OF BUSINESSüòÇü§£üòÇü§£üòÇü§£ CANT EVEN COBBLE A CONTRACT PROPOSAL TOGETHER IN 24 MONTHS. WOULD NEVER SURVIVE IN A REAL WORLD BUSINESS.   	NOT
" First thing that comes to mind is another Liberal hit job""  This is the damage Liberals (LibTards) are doing actual victims of Sexual Assault ..................they inciting doubt in everyone's minds.  Democrats are not a champion of Woman, nor Minorities.......they covet power URL"	NOT
  Possive dumb ass?	NOT
 I think he will get decent minutes win the champions league rotation coming into affect. He‚Äôs much higher up the pecking order than Herrera or Mctomminay. He is essentially the 4th choice for a 3 man midfield. So first option when resting or even more like today and last week!	NOT
 You are not alone! Will say prayers for you.  Hang in there!	NOT
4 and a half up on the Phillies! If you are a fan of any Georgia sports you know that no lead is safe!	NOT
#GOP on personal responsibility...  He was drunk: boys will be boys  She was drunk: slut  #republicans #conservatives #kavanaugh	OFF
 Bitter liberals are so funny.  Keep posting with anger!  So fun to read....	NOT
  He's been trashing all along even to our allies.	OFF
#treasonousgoverment california Tries New Tack on Gun Violence: Bullet Control URL	OFF
 That's new	NOT
  She is so stupid it scares us average Americans that she makes decisions on our behalf	OFF
 Just because he‚Äôs in love with her doesn‚Äôt mean she is. They don‚Äôt need to go there. It‚Äôd feel like another LF situation.	NOT
  Funny how the we need more gun control fanatics think they want a shooting war. Where are they going to go to get their free Obama guns	NOT
 bro they were laughing into her face and almost pissing their pants and i was standing beside it like wtf mind ur own business	OFF
  Tucker Carlson is not an idiot.  He knows exactly what he is doing.  That makes him malicious.	NOT
    What‚Äôs a book about President Trump got to do with an antifa pamphlet?	NOT
 Wow the guy who played the guy pitching a doggy product on Modern Family thinks he is the conscience of the nation. Also can I get Hamilton tickets?	NOT
  So Alyssa you saying he‚Äôs guilty?  What ever happened to innocent before guilty?  And if he is innocent would you at least tweet an apology?  Shut up and answer the tweet.	OFF
  I would think that if the pope was really a man of God he would have taken care of this problem in the Catholic Church instead of trying to cover it up	NOT
 Eric Holder is an arms dealer and should be in jail how did this ass slip by	OFF
  lol Why would conservatives want to hide that?  It contradicts everything Ford has claimed. ü§∑üèº‚Äç‚ôÇÔ∏è	NOT
    Sorry not antifa it‚Äôs the far right you know people probaly just like you who are so desperate to control women.	NOT
 Nope. Not going to miss his sorry ass at all.	OFF
   So she is protesting blasphemy by tearing religious book of a religion that doesn't have concept of blasphemy? #Genius	NOT
  Is it credible to believe he is worse than either: gordon on the browns in 2018 or 2017 brandin cooks?	OFF
 Lake show fuck Corey Harris	NOT
 Awh shit.	OFF
  I‚Äôve never once heard you be thankful. All you do is shit on Canada. On the police. On our history. On Conservatives.	OFF
Undertaker taking MAGA a bit to seriously smh URL	NOT
                                                Found some - please FB? URL	NOT
 It‚Äôs your opinion but mine is he is the best in the country	NOT
-Being on food stamps  -Liking boys/girls or liking both -Not knowing who you are -Your body size  -Not knowing something  -scared to ask for help -Not dating someone  -What you wear	NOT
 Deranged and demented what a perfect match for the Democratic party	OFF
 ........thank God it was not a mosque !!	NOT
 been supporting ur game for years as u know its about time u giys was free and able to communicate like you are doing &lt;3 hopefully only up from here brother	NOT
 Crazy how funny Jim used to be. Now it's funny how crazy he has become.	OFF
24 concert goers shot dead in Jacksonville with .38-caliber Smith &amp; Wesson. The NRA calls gun control research 'unethical'.	NOT
 Lol okay cuz this shit gotta be discreet üòÇ	OFF
 Die bitch	OFF
 continues to nosedive in ratings. Down 41% since last year. Their audience consists of weenie liberals in mommies basement. URL	NOT
 Thank Antifa for their special brand of authoritarianism  Just look at Sargon of Akkad	NOT
    Pressure from other liberals may make him change his mind. Their goal is the end result. They don‚Äôt care what it takes to get there.	NOT
 The antifa of the Muslim world	NOT
  Obesity high on the list. But people still care more about  gun control URL	NOT
 He is speaking to the best of the best  With utter disrespect ~   Our law enforcement Ice Agents  all first responders  Low middle and high class of all races and religions   DISAGREE Mr #CreepyJoeBiden  GRAVY TRAIN IS OVER PUNK!  #JoeDontTouchSoMuch Biden dirty hand joe	OFF
      #brexit    Chequers proposal is a disaster for Britain ! #ChuckChequers now ! URL	NOT
"  rae sis don't say no offense"" then like tweets calling me a sad bitch, also im truly shocked ur on the L6 train this year"""	OFF
 I‚Äôm jealous	OFF
 Go away already!	NOT
  When exactly did you adopt Malam? You have a catalog of articles as plain old Bolaji &amp; became Malam because of politics &amp; you are pleading facts here. Please	NOT
 Obama speaking unrestrained for more than 5 minutes....Trump couldn't have asked for a better gift and gun control Democrats just shot themselves in the proverbial foot URL	NOT
                  I make a deliberate choice not to discuss my lived experience of social security and any work and solidarity   with people affected.	NOT
    Q said to expand our thinking. This is what I came up with. I hope I put it in a graphic people can understand. #QAnon #GreatAwakening #PatriotsFight #WeThePeople #UnitedWeStand #KAG #MAGA #WakeUp #WalkAway #RedOctober URL	NOT
 do u have yuzusft face mod? i want it but i cant dl :o	NOT
 Oh shit this will trigger some bigots	OFF
. will serve the interests of Washington Liberals like  and   will represent conservative Kentucky values. #TooLiberalForNKY URL	NOT
 It's a red zone with no TDs.	NOT
 Woooow Trump voters are getting really crazy MAGA !	OFF
  Trump is maga	OFF
     What so democraps can do this to someone else? It's nothing but a smear campaign. Liberals just aren't honest enough to admit it.	NOT
    Antifa? Fighting neo-Nazis to oppose fascism is the same as neo-Nazis running over people with cars? This is pointless. Enough.	NOT
He can shout out to me any time he wishes.... #MAGA Thank you sir!  URL	NOT
       Gun control is racist. URL	OFF
" My thoughts and prayers are with the families.  Random mass shootings, which plague our nation, are not normal and we as a country can't allow them to be normalized,"" Craley said"",   The truth is these mass shootings are becoming too ""normal"".  Gun control would certainly help."""	OFF
#DougFord again using #Trump-style authoritarian tactics: ‚Ä¢Discredit the media. ‚Ä¢Repeatedly spread lies. ‚Ä¢Build a false reality for your followers.  These are smart people. The conservatives know what they're doing. This is a planned strategy to weaken democracy. #ONpoli URL	OFF
  He is URL	NOT
 Holder is unhinged !! Brainwashed	NOT
  Basically me and my liberals friends want to decide what's right for the rest of you.	NOT
 He is going to win!	NOT
After all my years of complaining im finally getting my bitch ass wisdom teeth out so I can stop fucking crying	OFF
 yesterday this happen hereüò≥ So much for gun control when you can't prevent a 2nd grader from bringing a gun to school huhüòè URL	OFF
     LOL at peaceful protest. Should i give you the full list?  Over 500 incidents Antifa attacked Trump supporters and none of Trump supporters attack Hillary supporters.	NOT
 No doubt she is proud of her daughter from Heaven! So sorry for your loss (at such a young age) How difficult it must have been &amp; I imagine to a certain degree still must be...She sounds as a truly wonderful person. You are her legacy!	NOT
 Is that how easily you are offended? Interesting... Good night sister. Hope someone brings a great twitter experience your way too.	NOT
A Madison resident who has posted a series of Anti-President Trump signs outside his or her home is at it again with another negative sign. URL	NOT
 Brexit &amp; conservatives as well that üôÑ	NOT
    if you are really concerned about anti-semitism in our society why have you both not condemned both The Tory Party &amp; The Lib Dems for not yet adopting the IHRA?    	NOT
  Look at her moving and not one word of Truth coming out of it. If you ever get a chance to ask that layer a question ask her do you agree with me that the Golan Heights belong to üá∏üáæ. She is dead dead in the water she couldn't answer it without condemning herself true	OFF
" The perpetrator is responsible for his own actions but you are ignoring that Maxine Waters &amp; others are inciting violence.  Do consider she said that they should not be able to eat, shop or do anything in peace""... how would one survive without being able to trade?"""	OFF
 As we should declare ANTIFA a terrorists group and investigate all of it's members.	NOT
  ü§£ü§£ü§£ü§£ü§£ü§£ü§£ü§£¬†Deep Throat	OFF
 Fucking sucks when the refs are against you. #KillTheZebras	OFF
The Whole World can see what President Trump has accomplished and Americans by-and-large are extraordinarily proud of the Trump  Administration.  It makes no difference what the Left and its Mainstream New Media dedicated conartists try and pull on us.  We are AWAKE #MAGA URL	NOT
  Can you ask Dana how worried she is for her home in (South?) Carolina? Is it close to the coast? I‚Äôm currently in N. Carolina (1st time visiting) and I get welcomed w/ a hurricane! Lordy day.. üò•üò®	NOT
"    I have indeed.A watered down needy statement. Not the robust condemnation in no equivocal terms one would expect. It begins with We note with disappointment..."" Such a diluted response suggests one thing: fear of the #Tories who clearly show no gratitude for your help &amp; support."""	NOT
 Someone's is asking if Davido wasn't supposed to be in Camp? Oga madam park well!! Davido's business is non of your business. Na u send am go school? Haterz... chop shit n die	OFF
  Islamists/Antifa/leftists would not allow us to lay a wreath in memory of the 9/11 victims	NOT
 LOL. What‚Äôs failing miserably is this 11th hour ambush by the liberals. Every minute #ChristinaBlaseyFord refuses to commit to appearing she and people like you lose credibility. I love it!! üòÇüòÇ #tcot #p2	OFF
  Obama is s sweet talker but very dangerous in his views and the actions he took and the scandals he has. Giving weapons &amp; money to terrorists. He aligned himself and bowed to them. Shadow govt to sabotage President Trump. Obama uses soros to fund antifa blm	NOT
  You are very beautifull	NOT
  No that is Antifa	NOT
 Trust me it aint ok to hit 16 - 21 year olds if you are 25 - 30 (in my opinion). But where were her parents???	NOT
  Got knocked out in the first round and one a shitty decision	OFF
    Where is your source for that?	NOT
  All U.S. WW2 vets are antifa.	NOT
 Gabole negatif thinking dong	NOT
I wonder if these are the false flags we were expecting......  URL  URL  #GreatAwakening #QAnon #followthewhiterabbit #MAGA     URL	NOT
  Oh he‚Äôs getting louder!	NOT
 hopefully you are an asu fan and not u of a	NOT
"#PeoplesVote  #StopBrexit    #remain  I don't want to go.. either, You know what, After we leave, My slogans going to be It used to be better than this"" should have stayed in. Useless goverment. URL"	OFF
  It‚Äôs ok Legatron we know you are the best and will bounce back with a new team!! Keep yo head up URL	NOT
  Yeah. He‚Äôs very immature &amp; can dish out criticism while crying and blocking instead of accepting any. It‚Äôs cool. Folks can see him for who he is mostly.	OFF
 Because claims if sex assault and rape are only political weapons to them.	NOT
 Srsly it sucks. When ur living life it‚Äôs full of bullshit rules we just gotta suck up to survive	OFF
 Laws not just for Conservatives or an unpopular group with the Media. Women have long failed other women and the Me Too is no more sincere than the Feminist movement was about Bill Clinton or Ted Kennedy.	NOT
    Totally fair. But the times it's happened to Serena in very important grand slam matches at the same slam. I get why shed be emotional. We're not in her shoes. Every match she is expected to win and it's clear she's not handling her nerves well anymore in these matches.	NOT
  She can lie in the shit she created	OFF
       Maybe stop attacking Conservatives and you might find they don‚Äôt retaliate.	OFF
"  I know the brown shirts"" in the UK were not an arm of Government then but ANTIFA and the protection they receive from our police and as shown the German Police seem to act like it."""	NOT
After you declare ANTIFA a terrorist's organization then start collecting the names of all the professors involved: URL	NOT
 The Irony is that most murders are done by illegal gun users who are gang members . This predominantly only affects Latino and black families. The problem is not gun control the problem is judges who let violent gun offenders back on Street after shooting someone.	OFF
Kyky do u love me ? Are u in Anfield ? Putain la cliiimmmm #LIVPSG	NOT
 Obama was the devil incarnate &amp; Trump is Jesus Christ himself. I get where you are coming from.	OFF
"    NRA tweet was a fraud: more than half of Americans say gunrights are the most important issue."" Falsehood. The 53% was ""gun rights/gun control"", and CA question indicates biase towards control. Deliberate knowing propaganda. URL URL"	OFF
  I think we should. But no I don‚Äôt think most American do. We divide ourselves in groups along social issues(Conservatives or liberal). Probably because we don‚Äôt have a labor party. Or a party that truly cloaks itself in labor identity.	NOT
 Burt Reynolds was the first so called Mega Star.	NOT
  The fake and bake twins!	NOT
Again if the economy is booming why is gas so MOF high 2nd question this is for the #MAGA cult how will making cars go half as far on gas doubling your cost to fill your tank make Fucking sense to you? #TuesdayThoughts URL	NOT
 to quit sex?	OFF
   Isis apparently obama let them run the world. Getting nuked by korea? BLM destroying cities. Antifa?	OFF
 I feel like this happens at the library except they argue a .30 fine because they don‚Äôt appreciate us and think she is doing us a favor by patronizing the library. But the family of seven with a huge fine on multiple picture books will write out a check then and there.	NOT
  &gt;&gt; old are you? [[She looks like a baby. Makes me wonder what she is doing in this kind of business. ]] Can we sit? [[I motion to the couch but I look to Dion for approval. I know I have no right to ask her or him to include me in their business.]]	NOT
"Susan Collins: 'Puzzling' Why Kavanaugh Allegation Came So Late""  URL #TCOT #MAGA #RedNationRising"""	NOT
 Republican-dominated Chamber of Commerce won't let him. Just like NRA ties his hands in any gun control. He'd like us to think he's in charge of everything.	NOT
  HYT ENEMY OF THE PEOPLE	OFF
  I'd still take this guy over a commie or antifa.	NOT
 He's a big crybaby because he didn't get his way for the 2016 election	NOT
 Girl you are so bomb üòç	NOT
 3D vs Digital „Äã War on Reality „Äã Going WHITE-HOT  We're now entering / the fight between&gt; Red-blooded humans in 3D /boots-on-the-ground reporters/ VS Avatar Digital AI /CGI Hollywood False Reality Reporting/ Polytechno-Fascists-Avatar-Digital Non-Reality URL	NOT
 So what I read was gun control doesn‚Äôt work and CA politicians are working against Californians sounds about right	NOT
   Gun control works real well in Chicago right Mr Alos	NOT
       IT WAS HIGH SCHOOL!!!	NOT
  I #WalkedAway .... from the   And I'm NEVER..... COMING... BACK.	NOT
 These bitches on my brain	OFF
  Agreed. It's probably white people screaming how offensive she is too. I wish Big Brother wasn't forced by the twitter SJW army to remove her. We have all said offensive things when we were teenagers.	OFF
"   He is by definition an antagonist in certain canons, but by no means an objective villain overall. frankly, they put effort in the franchise to make players/viewers sympathize with the character, even when he was the bad guy.""   so,,,arguable either way i guess"""	NOT
 It‚Äôs for pornhub...	OFF
 Perhaps the Myers House. Wynn runs Smithsgrove and he‚Äôs the leader of the Thorn cult. I used to think he was my friend until he revealed his true intentions. He is a madman!	OFF
 You are such a comedian edd!!	OFF
"  She knows something the liberals don't want to talk about. She said Canada was at risk"" three times in the House of Commons before she crossed the aisle. Coming from someone of her background, I'd be inclineed to take the warning seriously. Call me old fashioned."""	NOT
        What are you opposing? A neutral jurist sitting SCOTUS that weighs merits of a case as presented and determines COTUS adherance? MeToo=WarOnMen BLM=WarOnCops Antifa=WarOnSociety Abortion=War on POC &amp; POOR  #LiberalismIsAMentalDisorder #MAGA  	NOT
 i love you honey i hope you are okay take your time and take care of yourself üíï	NOT
" Everytime I hear that catch phrase now, u know, URL better than this"", I know hate is gonna be spewed."""	NOT
  She's tragic because she is an idiot and because she had tremendous internalized misogyny.   I think of the moment we are in the grips of as the Tyranny of the Half-idiot.	OFF
  LMAO CRY ME A RIVER YOU SCHMUCK! we had to put up with OVOMIT for 8 LONG YEARS! We kept our mouths shut and put our noses to the grind wheel!!!!! We didn‚Äôt RIOT AND CRY!!! GROW UP!	NOT
   . for president!! #MAGA #KAG	NOT
Kavanaugh accuser Christine Ford opens door to testifying next week Looking forward to the book  URL #MAGA #DrainTheSwamp #TermLimits #DitchMitch #PeelPelosi ‚Å¶	NOT
#Partybeforecountry #massmedia Conservatives‚Äô war on the press has gotten dangerous ‚Äî and it‚Äôs only going to get worse URL	NOT
 Yes keep voting until the NEW REICH IN BRUSSELS GET the result they want.  Call another referendum and just see what happens.  Go away Liberals your finished	NOT
  Mmm you are so hot	OFF
 Damn I felt this shit. Why you so loud lol	OFF
 Yes yes he is Melanie‚Äôs boyfriend.	NOT
Open borders will bring this to America! Dems are brainless! Vote red like your life depends on it because it does! #KAG #MAGA URL	OFF
  It wasn‚Äôt that long ago it was taboo for the left to be involved in the military or weapons at all...now they all want to be military so they can say they are gun ‚Äúexperts‚Äù and push gun control	NOT
 We should all believe Feinstein because she is so upstanding. She would never hir a spy from China and employee them for over 10 years. She needs to resign. TRADER.	NOT
 He's going to need a pair of running shoes so he can look for work when he's sees we're not supporting his dumb ass movies anymore. ü§∑‚Äç‚ôÄÔ∏è#walkaway	NOT
"   Hate to say it, but you got your sides mixed up. How many people have been beaten up, killed, etc by far-right radicals"". On the other hand, Antifa, Black Lives Matter, etc?"""	NOT
 You are so right on this issue and Democrats have been lying to the American people for to long lately it seems like there all going crazy in the head lol	OFF
  Racist all she is. My god less then 10% of population and cry üòø more then other 90 put together. Trump doing a great job just cause he got white skin ya don't need hate on him over and over and over	OFF
AntiPo is better than Antifa.	NOT
 Seriously who's the dick that unfollowed	NOT
  Reading these comments..this dear boy was burned alive!!!! And some are still talking about gun control! My gosh people!	OFF
"     And a whole lot more deadly than bump stock"":  URL"	NOT
"20 Crazy Things Liberals Blame Trump For""  URL #TCOT #MAGA #RedNationRising"""	OFF
 Just sick of everything being politicized and everything being presented as right/wrong good/evil. Used to be liberals and conservatives were viewed as generally good people with different approaches to achieving the same goal. Now it's 100% us and them.	NOT
 Cool!	NOT
"             They just all want to keep their CORRUPT &amp;  CUSHIONEY JOBS!!! THRY WANT TO GO BACK TO.....BUSINESS AS USUAL ""          "" I DON'T THINK SO"" !!!!!!!!!"""	NOT
"                  Sanctions used to be the action of last resort now its there weapon of first choice"" When was this? Taking account of this graph URL  from URL &amp; URL"	NOT
"#EndPC: Teaching guide for #Portland public schools celebrates Islam, communists, terrorists, #abortion; promotes #GunControl &amp; transgenders""~&gt; URL  #EndCulturalMarxism"""	OFF
 And they say Russia is the hackers.. Hmmm...	OFF
" Unfortunately, both Liberals and Conservative parties , leaders and fringe parties no longer know what Canadians really think! They said they  know"" , but that is House ping pong rhetoric ! Even the polls aren't reliable.  CANADIANS STARVED FOR A CLEAR STRONG VISIONüçÅMISSION! URL"	NOT
Here‚Äôs some more of what my opponent is ‚Äúresisting.‚Äù Are you better off today than you were 2 years ago? #NJ12 #MAGA #WalkAway URL	NOT
    Yeah bitch we put him back in and beat your sorry asses the bears SUCK!! BLEW A 20-0 LEAD LMAOOOO	OFF
 now we know tesco's stance on gun control	NOT
 What's doing detriment to this state (and country) is Republicans who refuse to govern as the conservatives they campaign to be. McDaniel may have some flaws (who doesn't) but he's the kind of fighter we need. Some of us are sick of the losers the GOP keeps giving us.	OFF
  She picks some random conservative issues from US and try to force fit in Indian narrative. Next might be gun control üò≠	NOT
"1/ [L]iberals and conservatives are on average no more or less narcissistic compared to each other. But the two political orientations are associated with different facets of #narcissism."" URL"	NOT
//i‚Äôll make a pinned tweet when i get home but She Is Here	NOT
  I still can't believe that you are 51 years old and yes your mom gave you some great genes	NOT
" Radicalism???  who's behind Antifa and other disruptive organizations causing havoc - your buddy George Soros.  Again, if you have a SPECIFIC accusation, you should bring it... all of your words are political rhetoric.  Nothing clear"" here."""	NOT
  Tbere aren't hardly any Conservatives left in California. Perhaps the threats are just unintelligible robo calls by Antifa comrades jacked up on Starbucks and Lucky Charms.	OFF
"&lt;BECAUSE YOU ARE MY ÌòÑÏû¨&gt; by Gi√≥ Ng√†y Thu NƒÉm 1997 x Golden Beryl.  Because you are my ÌòÑÏû¨, so I'll cherish every moment with you. You are my past, present and my future."" Link: URL #HAPPYHYUNJAEDAY  #BELIEVE_HYUNJAE_DAY #ÎÑàÏùòÏ°¥Ïû¨Í∞Ä_Í∏∞Ï†ÅÏù¥Ïïº URL"	NOT
 What exactly does he think he is going to do? He should be careful about how he goes around issuing sly theats.	NOT
  Lol.... your going to jail	OFF
   You‚Äôve got too many NewYork Liberals moving into the state. I see it in my town.	NOT
   Rabid nationalists who've been misled into thinking it's the liberals who are globalists.	NOT
"  Those other three are activist judges"".  They must be conservatives!"""	NOT
 Just because some flaky pink hat wearing woman says so? Try again. Where‚Äôs the police records and the like. Tired of liberals thinking they can lie to ruin someone‚Äôs life because they don‚Äôt like Trump	OFF
                                           Exactly that‚Äôs what liberals don‚Äôt understand we WILL DIE FOR OUR LOVED ONES	NOT
 Get that shit off my phone Bono - I‚Äôll never forgive you	OFF
 Shocking.  Consider most of the country wants smart gun control. Not the Wild Wild West like you espouse.	OFF
   He is awful. And so smug.	OFF
PANIC in DC - Sessions sent letter to Supreme Court re: direction for him to UNrecuse himself...  #wwg1wga #qanon  #MAGA #walkaway           URL	NOT
 You're very welcome! There are some INCREDIBLE bloggers I have connected with on here!	NOT
 Fuck me daddy	OFF
 Omg Jin‚Äôs laugh makes me wanna laugh my whole life. He is so adorable	NOT
 Your dad is my Idol an he is raising to amazing young men	NOT
   Candiace. She is trash.	OFF
 Clown	OFF
   Democrat  supports domestic terror group #Antifa URL	NOT
 Hmm! Maybe we now know why they see such a need for gun control - restraint of _their own_ overly violent tendencies. üòâ	NOT
  So conservatives freak out about coffee cups people kneeling for social injustice Nike shoes Etc I think it's the conservative that needs safe spaces	NOT
 Come on CNN.  He literally introduced himself.  The guy is a public figure for gun control.  Call him out!	OFF
    What the fuck was that dildo rider antifa fuck going on about?	OFF
" Yes, Joy  ?....  You were about to say Six-and-a-half years?"" Because that's correct, you sociopath.  You are ""stuck with this  ,""  f o r  t h e  n e x t  SIX-&amp;-ONE-HALF-YEARS.   #MAGA2KAG   üá∫üá∏ #WINNING"""	OFF
   And that‚Äôs why you‚Äôre a sheep. You think that Fox it‚Äôs viewers which would make up mostly Republicans/conservatives are all rich??	NOT
 Wait a sec .. shouldn‚Äôt Trump being proposing comprehensive vetting for gun control??  Wtf ? #GunControlNow #VoteBlue	NOT
 You not in GITMO yet? You do know you will face Jesus face to face don't you? Hope you repent before then because the wide gate and broad way you are on leads to destruction and it will be for eternity! Right now you are not looking so good!	NOT
  Dude... listen to yourself... igl is so much mure than just calling.. all the prepwork and everything.. yeah so niko called in one game or in one map... it‚Äôs like MIBR with cold n fallen... he is such an important player for this roster. 4 superstars and the team works. #KARRIGAN	NOT
 Apparently he had a photoshopped mustache as well!	NOT
 She is wortless why is she not checked out by secret service she is irresponsible in trying to generate hste to have somone kill thre president	OFF
   This is what is driving conservatives crazy. A GOP that won't stand against a dirty liberal mob. #WakeUpStandUpSpeakUp	NOT
 Not once did the left ask for gun control after Scalise was shot. Not once!   #VoteRedToSaveAmerica	NOT
  Lmfaoooooo	NOT
 Establishment turd üí©! Conservatives have a much better memory than liberals!! We don‚Äôt have eyes full of hypocrisy blinding us!! URL	OFF
".I think it's time we stopped being polite to and about the Left. They are not good people, they are walking filth. Small l"" liberals are their stooges, who don't see they are being used to destroy this country."""	NOT
"...We can no longer sit on the sidelines and remain silent on this issue."" - Chip Bergh, chief executive    This is what #PeopleOverProfits looks like. üëè URL"	OFF
  Liberals want Bert and Ernie to be gay.  WTAF.	OFF
And there we go ... so according to the MAGA believers kavanaugh  couldn't have attempted to rape Dr. Ford because her lawyer made a donation to  . Idiots URL	OFF
 another judge that first blames the tool then wants to make them dangerous to the legitimate user guess we know wher he is on gun control OUT TO LUNCH  your honor sir!	OFF
  Twitter and social media seems to make errors only on conservatives and never liberals. Why is that?	NOT
  The burden of proof is on Ford. She should put up or shut up. She is not credible by any stretch.	OFF
 fucking liar she was happy to play kate nash when you asked her	OFF
  Gosh Alejandro you cheating on us.	NOT
 #straightfire needs to win tonight. She is the rightful women‚Äôs champion. #hiac	NOT
  You religious conservatives need to stop trying to shame women for expressing themselves.  It's disgraceful	OFF
 Glad you are the same person. Keep up the good hard work.	NOT
  This is what happens when you allow employees to destroy your brand.  Americans will never choose Football over our Flag. ALWAYS STAND	NOT
" And today they don't even wear hoods. They're actually proud to show their faces. Unless of course it's their  terrorist  wing the ANTIFA or their crybaby wing the  RESISTANCE"". URL"	NOT
  It is all okay with the liberals if it furthers their agenda. They have no core.	NOT
 Thanks for spreading Joe Biden‚Äôs words...he is a great American that I respect very much.	NOT
 Yeah ... as if when a lady stranger randomly walks into your home the first thing you think to do is obey her verbal commands....  Sounds like she is trying to blame HIM for his own murder.  Unbelievable.	NOT
What a dilemma! #MAGA #NEWS #NikeBoycott #ColinKaepernick #nflfootball #NFL #TrumpResign      #CNN URL	NOT
 Hey Jimmy  The View had Norm on.   THE VIEW!!!!!  You're sad.	NOT
"    What you're doing is so irresponsible &amp; I believe that ur smart enough to understand how evil you are. If the FBI or JD had some plot to thwart DT, all they had to do was leak"" to the press that he was being investigated. They DID NO SUCH THING. U know you're wrong, that's evil!"""	OFF
Thank You  We Need to #BuildTheWall to Keep Them Out But Mandatory E-Verify Will Get them Out !  #RedNationRising  #Trump #MAGA #SendThemHome  URL	NOT
 Thank you!!üò≠‚ù§Ô∏è	NOT
 Just like the gun control poster child David Hogge. You don't hear from him anymore. One and done	NOT
  You are not fooling anyone with what you say. If it was the SNP doing this you would be screaming blue murder. Mind you until you do the job you are meant to do. You and your fellow workers will be looked on as being part of the Establishment. Bought and sold.	NOT
  At least she‚Äôs now getting laughed at. URL	NOT
 Watching liberals get all uppity at you though was the best part.  They jump to defend the scum as ever.	NOT
 she is uncultured	OFF
                                                  Go take Economics......We'll waitüòí	NOT
AntiFa fascists and Socialists are one and the same......time to respond ! URL	OFF
   She has tooo many details to be lying but they still will say she is lying	NOT
 shit ain‚Äôt gone work bruh URL	OFF
 Acting like an ass is not a good view.	OFF
                     I know many of antifa who will fight harder....and not waste government socialist money URL	NOT
" Damn...that's almost as old as I am!  Then again, he is from Utah, and he does what career politicians do...appeal to his base""!"""	NOT
So summer camp is relatable to detention centers? Liberals will paint any picture to get a non-existent point across. #maga URL	NOT
 Awesome Agree Yeah man Preach Wait... what did i just read? Oh shit	OFF
  I'm sorry but damn she is hot af	OFF
 No reporting on the death threats faced by Kavanaugh or ANY conservatives huh?	NOT
    nvm he is dodging us we can Play you now	NOT
 CNN is neither there to make money or tell the truth It solely exists to be a propaganda arm of the Democratic Party	NOT
"   I purposefully had my damsel"" be a bit of a badass. She is saved by the protag, saved by the third party member, and sticks her neck out to save their hind quarters just as often (if not more!). Sure, she may have ulterior motives (*evil laugh*) but she's still pretty kickass!"""	OFF
 2 ways for President Trump to lose in 2020. Gun control and an immigration bill with no wall.	OFF
 Thank you Don Jr! You are absolutely correct!	NOT
 Don‚Äôt care. Let them (NFL) die on the field kneeling	OFF
 ATTENTION ALL RED VOTERS!!! GET OUT AND VOTE.IF WE DON'T WE WILL LOSE EVERYTHING.	NOT
 Every one of them need to be put away for life	NOT
 Hiding like the caged animal he is.	OFF
     Your narrative is so false it is comedic. You and people like you are frauds.	NOT
 Conservatives are so sick of these tactics by liberals. First there was Bork then there was Thomas. Republicans just keep taking it too...Trump won‚Äôt take it for long though. URL	OFF
 thank you sm and it was great meeting you too!! seeing you and my other favs reminded me that its so worth pushing through the pain to be able to do things like that!!	NOT
 Perhaps FBI etc. Should look into Orrin Hatch closet and investigate what he is hiding Sex Offenders always stick together	OFF
    Riots everywhere üò°üò°üò°üò°üëäüëäüëäüëä	NOT
 College football is much more interesting than the NFL protesters.	NOT
"    The only one suffering terrorist attacks is Mussolini""  even if that were true, the way that ""terrorist"" is generally defined (as ""doing violence against power, outside of government realm"")  of course its true  its irrelevant, Hitler by that analogy wasnt a criminal. Antifa was"""	NOT
 2 Cor 5:17 ‚ÄúTherefore if anyone is in Christ [Consciousness] he is a new creation. Old things have passed away and look! New things have come.‚Äù	NOT
           Fluffy was found üêà‚ù§Ô∏èüíôüêæ‚ÄºÔ∏è	NOT
Make sure you Vote REPUBLICAN up and down your ballots. Vote RED for conservative  values. Vote Republican candidates only to help our POTUS Trump help Americans to MAGA URL	NOT
 Agree. People forgetting how good he is.	NOT
 you are a hypocritical hack. URL	OFF
 Should I share the quotes from notable U.S conservatives?	NOT
 And people still buy their shit. Why?	OFF
   ... those are conservative values? Last time I checked those were more descriptive of liberals than conservatives	NOT
   Such as?  Cable?  He got snapped up pretty quick after he was fired.  Not saying he is a good coach but people in the league obviously think so	NOT
Business is business. I love this story.¬†URL	OFF
 Liberals are claustrophobic? üò¨	OFF
 Holder is a complete corrupt scum bag. I remember when he announced his is part of the resistance. Which means he want to resist the people who voted for Trump. Can U imagine the people he would have hunted down and prosecuted if this happened to bone head obama	OFF
                                                  Anarchists are left wing extremists. They stand with antifa.	OFF
 You niggas spend on us and we get used to it. I hate to admit it but half the things my boyfriend does for me I can‚Äôt do for myself üòÇüòÇüòÇ	OFF
  We seem to have less shootings that you guys.  Apparently you need more gun control laws.	NOT
  Hollywood #EmmyAwards = Anti-First Amendment (ANTIFA). They‚Äôll obviously shut you down if you‚Äôre not part of their cult.	NOT
  She is your sister????	NOT
 Thanks for the kind words! We're so glad to hear that you are loving the mattress! üòÄ	NOT
      You are a child. Don‚Äôt even talk to me. Lmao.	NOT
 lie detector test?  no such thing.  if you mean polygraph   it doesn't detect  lies or truths   yes  Kavanaugh should ask for an fbi investigation into Dr fords history	NOT
 Exactly. We can take the theatre. üëç	NOT
$10 B/W commissions are still available!  Please DM if you are interested!  #artistforhire #commission #robots #anthro #furry #monstergirls #cyclops #pokemon #magikarp #catgirls #possum #artistsontwitter URL	NOT
                                           Okay ü§ó	NOT
 You are strong girl. Don't listen to the trash talk. They don't know anything. You just go and tell the truth. That's all that matters. üôèüåäüôèüåä	NOT
 Cuz liberals are sick of cnn!!!!	OFF
  You're on Twitter so you have the internet? Here's a condensed basic history.  URL	NOT
 Us conservatives hope he does.	NOT
 BOYCOTT THE ANTI AMERICAN NFL. Football ain't all that anyway.	NOT
 Hope they're brushed up on their very large negative numbers!	OFF
  Don‚Äôt they have strong gun control in Chicago? So nobody should be getting shot. Oh that‚Äôs right only law abiding citizens are being shot because criminals don‚Äôt understand they can‚Äôt have guns...Gun control is not about controlling guns it‚Äôs about controlling citizens!	NOT
    do you like/love Louis Farrakhan because he is a racist or an anti Semite? Which one?	OFF
 You don‚Äôt get it it all. Women don‚Äôt like to come forward because of men like you. When they finally do come forward men LIKE YOU either slut shame them or call them liars. Men LIKE YOU are shy a lot of victims remain silent.	OFF
... ammunition is in many states easier to buy than cold medicine...'   California Tries New Tack on Gun Violence: Bullet Control URL	NOT
  You missed seeing Pruitt chewing butt all the way to the end. He's all business. I love it	OFF
 Dude. What the fuck is WRONG WITH YOU?  I sent you a direct tweet to show you how you re-tweet your OWN shit. Then I let it go. Now you want to double down?  Just go back to Whoviille	OFF
  He is!  Lock him up!  Lock him up!  :)	NOT
 He wants his 5 min of fame.	OFF
 Hang in there. She is alive.	NOT
 #Causality? Is it:  1. Chicago lawmakers instituted strict #guncontrol BECAUSE of high pre-existing crime rate? 2. Crime rate is high BECAUSE strict gun control prevents law abiding citizens to be armed - so only scofflaws have guns? 3. No causality at all. Statistics are #COHORT	OFF
  Agreed. I have better ideas: ABC‚ÄîLet AntiFa beat her to death at a pro-Trump Free speech rally.  1/	OFF
 here we go this is where the nats blow a lead now or the 8th inning have you not learned and strasburgh is not what everyone thinks he is inconsistent	NOT
#Tyranny #Totalitarianism #Leftism JUST WHEN YOU THINK #THELEFT CAN'T SINK ANY LOWER - #Liberals fear their major cultural victories of the past half-century are democratically... URL	NOT
 yo he is gorgeous üòçüòç	NOT
 I already knew that ! LMAO üòÇ SO stay with us deplorable bigots!! We‚Äôre getting ready to fight for our COUNTRY! #WWG1WGA	OFF
 Element of surprise has gone then Somehow i think this is more	NOT
      A popular vote would be terrible! We would become a Democracy!	NOT
"   Freedom From National Debt"" is also very good and written by former Deputy Secretary of the Treasury Frank N. Newman. Also great cuz he is not an MMT academic but basically confirms MMT from a non-MMT insider's perspective"""	NOT
" A much more traditional"" take on the Lois &amp; Clark dynamic is showing up in Tom King's Superman 100-Page Giants at Walmart. I would recommend it. She is not SUPER-heavily featured in the first issue but she is well-treated."""	NOT
         You mean like all the Liberals screaming at a SC nomination hearing? That kind of clown show? So tell me since when do accusers get to make demands? This isn't a university misandry board of injustice.	OFF
 Yes he is and it's giving a Good View	NOT
 Boy is that professor stupid or else has a mental illness. He obviously should not be teaching anyone!	OFF
 Bono is utterly stupid ridiculous wealthy tax avoiding hypocrite fascist  I can‚Äôt listen to U2 again	OFF
 Oh no! Hope you are okay.	NOT
 An insult to holocaust survivors and their families. An embarrassment to film making.	NOT
IN HONOR OF #ConstitutionDay  I PURCHASED A #TRUMP t-SHIRT AND A #MAGA HAT  #TRUMPTRAIN #LIBERTY #FREEDOM #AMERICA #USA #LIBERTY URL	NOT
 What do you like to do when you are with your family? #AskAlly	NOT
 Thank you ! Yes he is so sick üò≠	OFF
 no one attacked Kavanope!! We are allowed to question  liars.  He is secretive and He lied under oath. What more do you need?	OFF
 Bigly....lol.....bigly? He didnt won...he was elected by the people of the united states ahole...what he'll are you referring to? Antifa fools that get their asses kicked...vagina hats..lol pathetic ass	OFF
 looks like antifa	NOT
 True point.  Gun control is total bullshit.	OFF
 You are a bad ass! Keep fighting for us üíï	OFF
   Check this ad out. Super creepy  People are pointing out a disturbing problem with this Republican election ad URL	OFF
  No liberals calling for  to resign URL	NOT
 and why do all the issues about Pc only focus on liberals What about conservatives on kneeling on fake patriotism Or Republicans freaking out over an abortion	OFF
"Judge Dismisses Lawsuit of Berkeley Student Injured at Protest of Yiannopoulos Event""  URL #TCOT #MAGA #RedNationRising"""	NOT
"         They lie about firearms. They call the AR-15 a fully semi-automatic assault rifle."" They push gun control.  They say Donald Trump is racist and hates Mexicans.  They say he colluded with Russia.  So yes, they lie"""	OFF
 And then wana talk shit when you play something they don‚Äôt know but the song be fire and end up blowing up then later becomes they song ü§¶üèæ‚Äç‚ôÇÔ∏è	OFF
"  How's not going low"" been working for conservatives?"""	NOT
Elizabeth Warren Fundraises off Sexual Misconduct Allegation Against Kavanaugh URL via 	NOT
 I said the same thing today lol	NOT
" If you are into comedy movies the galpal flick Bookclub"" is both funny and heartwarming! Diane Keaton ,Jane Fonda Candice Bergun and Mary Steamburgen are just part of the fantastic cast! Made me laugh from beginning to end"""	NOT
  Milk is meant for calves not humans. Give your head a wobble	NOT
 Why do affluent liberals like Cooper who claim to support diversity usually live in areas without much diversity?	NOT
 I don‚Äôt trust Kanye right now. I might not like that shit.	OFF
 This smells like another funding of George Soros. Follow the money üí¥ trail.  That woman most likely never knew Judge Kavanaugh. liberals are running scared because The Judge has conservative Christians values. The man has an impeccable Portfolio. Finestine‚Äôs a dirty politician	OFF
        ACHTUNG - It's today vote now being question by Hungarian   -	NOT
 You are way to good at this	NOT
  Case and point society through mind manipulation is causing people to do horrendous things hurting weaker creatures is a sign of a deeply troubled individual but yet the left focuses more on gun control than on getting to the core of the mental health of the people	NOT
   simply cannot accept failure. Former President Harry Truman he is not. Trump will always look to blame others.	NOT
 #Deplorables are resolved to #MAGA URL	NOT
 he‚Äôs obviously a bitch	OFF
 The  are currently polling 6% Chuka. Khan will lose London to the Tories at next mayoral election. But that‚Äôs the aim of the Blairite cosplaying Tories. Keep the Conservatives in power stop any real alternative to the Financial services 2nd British Empire gaining power. URL	NOT
"  To the view"" all the persons involves in the show- please you are better than ""this"" to have self promoting ""stripper"" on with her lawyer  please don`t lower your standards !!!"""	NOT
  Investigation reveals it is highly probable it is an ISIS attack. Worst case scenario a joint ISIS-Antifa attack	OFF
"President Trump's economy is the rising tide that is lifting all boats. This is especially true for Hispanics who were among the biggest victims of the low-growth, high-regulation economy under Obama""  Hispanics flourishing in Trump economy URL #VoteRed #MAGA"""	NOT
 He is irrelevant	NOT
 Those idiots are fringe right. They are hated by most conservatives.	OFF
 henry is so fucking great and was def my #sickkidsinlove inspo and i love him and his death is a PROBLEM	OFF
 Amazing that the Dems are always the ones who hear the whistle.	OFF
 And the last one when she is with herself. The truest personality.	NOT
   Now we just need antifa outside when they confirm kavanaugh	NOT
 Right..? Total OCD right there lol Yeah...totally gonna floss that sucker off.	OFF
 You meant to say for yourself. Now is it time to talk about gun control?	NOT
#MRU in the media | Liberal MP crosses floor to join conservatives  via  #CdnPoli URL	NOT
 Fuck yeah!	OFF
 I hate him im so fucking sorry	OFF
 He is saaaaaaadd üòÇüòÇüòÇ URL	NOT
 There is a full-blown coup d'etat going on between the Deep State and the Liberals for everything they can do to try and get Trump out of power and it's absolutely ridiculous and should be against the law	NOT
 and  you need to find this lady! Do your thing. She is a terrorist waiting to strike. URL	OFF
  I know this is most likely a fake profile set up 2 get conservatives unhinged so this nut can report them. Just had 2 get that off my chest!	NOT
 Billy bargain üëç	OFF
" The 1st word Rian Johnson used is regret"", and he asked about fear. So Rian Johnson must have thought of these 2 emotions for Ben ... I conclude that Ben regrets that Rey didn't accept his offre and fears to be alone and that she doesn't love him as he does üòã#Reylo"""	NOT
 Kamala Harris speaks to those she disagrees with in a condescending fashion that I find gutter like! I want to snatch her bald headed routinely! She is so full of herself and is very unbecoming! üò†üò°ü§¨üò§	NOT
 Conservatives; the trailer trash party of Canada.	OFF
 He‚Äôs so yesterday	NOT
 What about the other to girls was that sinnfeinn fault as well oh right it's only the ex hard line republic you are interested in she is the only victim because she would do aunt thing to bad mouth sinnfeinn shame on you	NOT
"#guns #2A A Second Amendment Zone"" is Ridiculous. So Are Concealed Carry Laws ‚Äì Daily Utah Chronicle: The latest installment of the nation‚Äôs endless debate on gun control recently surfaced on the University of Utah campus. A g URL URL"	NOT
"      UNDERSTOOD, Sir! Nation HUNKERED DOWN in our COMMITMENT 2 help you #MAGA, in your God given STABLE GENIUS words: Till The Bitter End""... God speed Tziyon, Shalom! Con musica, Lucho, Latin Jazz Vocalist&amp;Composer"""	NOT
 Anita Hill wasca liar then and she is a liar now.	OFF
 These are truly beautiful and unique.	NOT
 I hope he is safe	NOT
 But you are? Give me a break!	NOT
  I was waiting on him to say the hokey pokey and they turn themselves around. lol Seriously what the heck.	NOT
  Did  advise Iran to do this since he is there go to guy?	NOT
" Bob dickbrain"" Woodward. ""I wish I were Ann Coulter."""""	NOT
Constitution Day -- the Most Important Commemoration of 2018 URL  #ConstitutionDay #MAGA #KAG  #Obama #Clinton #DeepState abuse of power: #Spygate #WitchHunt #Sedition=#TREASON	NOT
  They always get mad when they are losing money. üá∫üá∏	NOT
 Don‚Äôt doubt a fat man	NOT
           We all had fun!Loved watching eyes light up w excitement when he used their names as they asked questionsüòçYes!He is talking to you!üòç	NOT
 All those poor conservatives going to be asking for government handouts and relief.	NOT
                     Follow everyone on this tweet. We have to fight Twitter AND the Democrats!	NOT
 He hit the lotto	OFF
 I should make a ‚Äúsam has new hair and she is fabulous‚Äù sign that I have on my person for when we are together	NOT
    So he is misogynistic cause his opinion is different?? I guess that makes you a bigot!	OFF
  I agree he is very intelligent and I like the latest policy of a sovereign wealth fund - something I've long supported. But he just doesn't cut through. Someone like Jo Swinson would get the party more air time imo.	OFF
 Most definitely. I‚Äôm not advocating playing either game. Just thinking aloud they might play earlier.	NOT
 they‚Äôre abso shite quality tho	OFF
 He needs that exact amount in hanging rope.	NOT
 i love your voice. how do you get it to sound so sexy and strong? #BarbieDreamsVIDEO	NOT
   But ... but ... I was trying to get him to block me. The trans porn story was the perfect ammunition ... but now it will never happen! üòÆüòßüôÅüòûüò¢üò≠ URL	NOT
 lmaooo you are so wise ily	NOT
 Oppression... We need to start a movement.   Could be worse they could be Antifa dogs :)	OFF
    shitt on Pitt - perfect for wiping the seat! URL	OFF
 Too bad!  Never liked him since I met him years ago!  Very uppity but you see what goes up must come down!  Never think you are too good for anything or anyone!	NOT
             We‚Äôve also written a post about 5 metrics to measure the success of your B2B podcast: URL	NOT
  Which some fantasy gun ban you‚Äôre rolling over in your mind would prevent?    Gun Control Is Evil Misspelled  URL	OFF
  ikr? Riding trainer? Have fun running to Lower Rear BackWoodsistan Fucker!	OFF
                    Jaws V: When Jaws Jaws Back - Starring Kurt Chiselchest and Lorna Buxom  Whud I win?  It better not be one of them laser swords...Jess will b jealous.	OFF
 A military tribunal will get Holder.	NOT
 Good Day   I trust that you are well  Please send me your email address	NOT
 Right.!!!! I don't know what the hell he is saying half the time. I would get thrown off the show the first episode.!!!!üòüüòï	NOT
 You would. Can't fix stupid.  #MAGA #QAnon #ThursdayThoughts #DrainTheDeepState #ThankfulThursday #WWG1WGA #WalkAway	OFF
    I knew we would find out that this is all the liberals‚Äô fault. üôÑ	OFF
 ü§£ü§£ü§£ü§£ü§£ü§£ü§£ü§£ü§£ü§£ü§£ü§£ü§£ü§£ü§£ü§£ü§£ THAT SUMS UP THE STATE OF LIBERALS	NOT
 Conservatives have become the cadaver party.	OFF
 He is making faces like Peter strokz...	NOT
 His name is Coco!  He is a Pomeranian.  He's actually old.  He's is 12. The most loyal dog I have even known!	NOT
   Different story now he‚Äôs attacking Liberals isn‚Äôt it ü§îüòê ... he‚Äôs been doing this this since #KillGough Wasn‚Äôt an issue back then tho (apparently) #auspol	NOT
  Pushed to my limits. URL	OFF
 His jewels have their own gravitational field!üõ∏	NOT
  Brilliant! #MAGA #WalkAway	NOT
#Muslims and #Islam finally got their #WhiteSupremacist #Terrorists they have wanted for so long they can harp on about and say were worse than them ..  Two 15 year old boys from #Ramsgate!  Jesus ü§î  #MAGA #MEGA #MCGA #MBGA #Conservatives #Patriots URL	NOT
 Trump is just playing whit liberals I bet this is his way to help conservatives win next elections and take credit. Trudeau is in the corner right now. Any deal whit USA will be bad for Canada.	NOT
 she is back !	NOT
  The left have become a bunch of thugs. #NancyPelosi #chuckschumer	OFF
 I do love you but don't give him an excuse..he isn't mentally ill he is a dangerous idiot!!!!	OFF
  Latino Conservatives=Self-Hating Freaks	OFF
 Can we talk about how he is having the worst year of any player in yankee history?	OFF
 YOU ARE HELPING THE #RedWaveRising URL	NOT
 all those muscles	NOT
    Coming out of closet and admit he is Russians asset	NOT
                                                 Hahah yes because trump beat Obama in the election ü§£	NOT
1. My love ~ 2. . . . okai . . there you are ~ URL	NOT
    I am suggesting ways for our Climate Barbie to lead by example. Something liberals don't know how to do. 5 ethic code violations will prove that.	NOT
    You liberals are so ‚Äú nice‚Äù and ‚Äú caring‚Äù	NOT
 He is so brutal. Hopefully he sells the team...	OFF
" Now to get inner cities, i.e.#Chicago, to have policies that promote job growth there so that the #nuclearfamily returns. The lack of one is why   have the daily killings, NOT a gun control"" issue. #twill"""	OFF
" It's called FDS or otherwise commonly known as not getting your way"". Antifa members hard at work. üòÇ"""	NOT
"2) In a weird way the debate about Section 33 reminds me of the gun control debate in the US. They have laws that allow people to own guns designed to kill people yet are shocked when guns are used to kill people. We assumed they would restrain themselves."""""	OFF
  Dolt. You‚Äôve become another nail for Hammer Trump.	OFF
 It's fine..... he's gods Prophet üôÑimagine that nowadays... yes officer i did fuck that elementary student BUT its fine bc god said i could....	NOT
50 year mandatory minimum for ANY crime committed with a gun will substantially reduce violence and put end to gun control babble. NO POLITICIANS will support this because they don't care. Why you ask ? Because they're politicians FIRST #TermLimits URL	NOT
                 Is the blind man  a fash that antifa needs to thrash? Beating up blind guys is over the top!	NOT
 He is compromising an active investigation. Sounds like obstruction of justice to me!	NOT
  It also means her treacherous actions will seriously offend 70% of  who voted to #Leave all *Four Pillars* of the CORRUPT #EU. #ChuckMay #ChuckChequers #BoJo4PM	NOT
 So babies aren't future men? I suppose ripping their limbs off and sucking their dead bodies out and putting them in the trash. That's sorta thing?	OFF
    OK..... you are wrong	NOT
 Like ANTIFA.	NOT
   You are goddamn right both sides will be heard. We want the TRUTH Kavanaugh. Republicans better not put party above country.	NOT
 They just need to go away. No one wants to see them in the media advocating for gun control. It's unseemly.	OFF
"  These gun control scientists"" are a disgrace. They should have their license to publish revoked. üòí"""	OFF
 Please and that bitch will get popped and end up with a lump like her dumb ass sister üíÄ	OFF
 I wonder if  ground seen if Kaiser is ok if I was him I would of went and got him idgaf all he is worried about is his body building	NOT
   As a veteran of the US Army I have supported different presidents over different periods of my life. Not gonna sit back and watch no one man disgrace #america like this. Be happy with who you support cause he is not good for your country #usa #VoteBlueAndBringAFriend	NOT
#WeMarchForOurLives  #EnoughIsEnough..what say you   we need  Solves Guns special... and the USA fall election (   focused electing ONLY those for actual gun control-dump old #DNC #GOP - with #empowerment 4action URL	NOT
 UK Govt non announcements are the only consistant and affordable policy under Labour or Conservatives for decades. Designed for a soundbite. No immediate resource required. Never likely to ever be implemented. Its propoganda but sadly it has its desired effect.	OFF
#TuesdayThoughts Got a gut feeling TWITTER is now in the gunsights of the Government and President Trump for Anti-Trust violations censoring and shaddowbanning Conservatives --- watch for Big News coming out soon.	NOT
 You are becoming unhinged with this game....	NOT
                                                  Hmm? That‚Äôs not biblical. You may want to ask god if you are doing it right. I‚Äôm pretty sure you‚Äôre supposed to get in that church with all the ‚Äúpeople‚Äù you don‚Äôt care to be around. It‚Äôs your persecution. üòÇ	NOT
   Planned Parenthood provides millions with CONTRACEPTION - thereby eliminating an unplanned pregnancy for most; an unplanned pregnancy that doesn‚Äôt potentially result in an abortion.  Conservatives possess no critical thinking skills whatsoever!	NOT
   You gotta prove to the world who you are bale!	NOT
"  Conservatives"" try to preserve institutions that young people are constantly trying to destroy because the aging left brainwash them into taking action. Young people have no conception of a sense of maintaining effective systems. Most are connected to destructive impuse."""	NOT
 You're part of the problem! No more Regressive Liberals. #DrainTheSwamp URL	NOT
 State level crime when the alleged offender was a juvenile. Silly liberals no crime committed by Kavanaugh but probably one by the liar Ford #DemocratsDividingAndDestroyingAmerica #DemocratsHateAmerica	OFF
  I think he is racist out of touch with reality he treats the presidency like a reality show we‚Äôre he is starring he has no empathy he is suffering from narcissism he has an in ability to tell the truth he may be mentally incapable of being the President of our Country URL	OFF
  You are correct the one LRT line doesn't but the overall plan does. Transit plans need to start some where usually with a back bone line that you can expand upon and tie into other parts. Why not start with a heavily used corridor funded by the ONT government?	NOT
  Thank you 	NOT
  Kerry needs prosecuted for colluding with Iran. This needs to be done quickly. Revoke his security clearance &amp; remove his passport. He is a traitor--always has been!	OFF
 Eight years the republicans denied obama‚Äôs picks. Breitbarters outrage is as phony as their fake president.	OFF
 I am and I'm voting absentee for the first time in a midterm!! #MAGA	NOT
 Got your ass lmao	OFF
 A curly fry in horsey sauce at Arbys and a fry-frosty at Wendys is how you fast food.	NOT
"              Yes they can, Dickey Amendment  ""None of the funds made available in this title may be used, in whole or in part, to advocate or promote gun control, the provision states.""  They can research all they want, they just have to stay out of politics around gun control."""	NOT
7th and 8th grade football will be looking for parent volunteers to help assist with our concession stand.  If you are interested you my email me at darell.maddox	NOT
   Trump is declassifying information and there is nothing you can do about it.  He is NOT the subject of an investigation.  The FBI and DOJ have repeatedly said as much.  Go back to your quackery.	NOT
  Maybe consider this instead Theresa May isn‚Äôt real name. She‚Äôs Annette Johnson a Mediterranean and the conservatives are now a terrorist org. Sod chequers üôâüòá‚≠êÔ∏èüåà‚≠êÔ∏è URL	OFF
  This proves that liberals only care about these issues when Republicans are in control.	NOT
     She just knew she was having a girl!! She is excited now!!	NOT
 Nigga you are tweeting in the shower ???? I hope Siri drown	OFF
 Zim is?  If he is than what‚Äôs that make Peyton?  Lol. URL	NOT
  Is the vulgar Antifa creep TRYING to look like a woman..or is it that he just can't HELP IT?	OFF
. Yes. Debunked. URL	NOT
 Cat fight URL	NOT
 Tough to say because football manages to appeal to all sides of the spectrum except maybe the far most liberals...(sorry for the rant lol)	NOT
" Same paint ball range they used for the antifa vs Proudboy"" match last year"""	NOT
 Be quiet SheDevil URL	OFF
 Cause the CIA and FBI WAS good at the time to cover up the greatest corruption ever made by Hussein Obama administration. It‚Äôs all coming out All involved with the Deep State.	NOT
  American Conservatives Don't give one shit about the terrorist group Hamas or what they think and or believe.	NOT
 Of course it does. But they weren't interested to him. Domestic abuse is still domestic abuse. So I hope you didn't use this fake rumor just to shit on the habs and that you actually care about domestic abuse.	OFF
"  that's always been the critique to be honest--hence the champagne socialist"" or ""privileged white antifa"" tropes"""	NOT
"    So handsome you are! I think people should donate the  shoes to our homeless veterans and other homeless Americans, after they sew a no"" circle over the emblem."""	NOT
 the dopest most illest female artist ever! That's fucken queen right there hands down!!! Try to argue widditüòãüòò	OFF
 Liberals ....cry and complain that all they do URL	OFF
 Don‚Äôt judge us Mainers by this (clearly insane) proclamation. He‚Äôs off his pins.	NOT
  Aren‚Äôt you late for your antifa meeting?	NOT
üõë Truthfeed News üõë üëâ 'Schumer and Feinstein Go HYSTERICAL and Issue Unhinged Demands to Delay Kavanaugh Vote' #MAGAÔøºüá∫üá∏#2A #Prolife URL	NOT
  Antifa is hatred incarnate	NOT
 Goodell should resign. That would be social justice.	NOT
" Why are you acknowledging her existence. Time to block her and give us all a break. She is a nobody"". She use to be a funny comedian who gave away her power to hate and lost almost everything."""	OFF
 Fuck Alan I‚Äôm sorry	OFF
 What you are suggesting is thoughts &amp; prayers wouldn't have given you this picture that science &amp; technological advances did? #Science	NOT
"3)  Conservatives think it because the NeoCon infiltration that successfully corrupted, and nearly destroyed, conservatism has been brainwashing them for decades to accept anything with the free trade"" label as good - and anything with ""protectionist"" attached to it as bad."""	OFF
  Do you know why this shameless muslim socialist is still so arrogant and believes in himself thst he thinks he is such a good politician? I‚Äôll tell you why. So many ‚ÄúStupid American Voters‚Äù per Gruber that are so gullible!	OFF
 Why you ignore my best friend she all deserve your fucking follow she love you with all your heart she waiting for 8 years üôèüèªüôèüèªüôèüèªüôèüèª 	NOT
Actually I avoid purple because everyone loves it and I‚Äôm addicted to pissing people off. I also detest the color purple. URL	NOT
...Or conservatives trying to get Bill Clinton... you get the idea. URL	NOT
 Keep Your Pelosi Money !!!!!!! #RedNationRising  #MAGA  #WalkAway	NOT
  When tRUmp posts shit like this you know that he is distracting from something else that is going on. #Distractification	OFF
" Thanks. So the large corporates are going to have to take it on the nose""?  Reason for asking is that they:  1/  Employ a few people in UK, who might not want to see their emplyers leave, and 2/  Represent part of many peoples pensions  "	NOT
   Just goes to show you can be deluded and misled on several and subsequent occasions! I‚Äôd ask Dr Lee for an urgent appointment on the grounds of the fact you keep getting these delusions! ü§îüò°üá™üá∫	NOT
 Fuck yeah you are!!!!	OFF
 We all know #Liberals' poll is completely a BS.	NOT
 The Republican Senate already know who he is that is why they won‚Äôt release those documents	NOT
    Everyone has a life story - that is no excuse for being aggressive. If anyone is to blame it is the producer for inviting KW onto the show. She is clearly not well &amp; shouldn‚Äôt have been put in a position where that could happen. Her management should not have allowed it either!	OFF
  you have a lot to atone for. You better atone for all your lies. I used to think you were a better person. I can‚Äôt see anything but evil.	NOT
 God I hope shes' wrong!	NOT
  Umm she is a reporter asking a question. The Senator is acting like a baby. Is this really what adults act like? Shame on you CBS. Shame.	OFF
     Where did I say he is unplayable? That was the other guy. But vs Houston on the switches in a potential first round series? Sheesh it wouldn't be nice	NOT
  I don't agree with you. But if you want to see a real damsel in distress play the fucking marry Jane missions. They are soooo boring . she's so stupid. URL	OFF
 hallo how are you today i think you are good actor	NOT
  Sloppy and pathetic.	NOT
 Proud to be Antifa AF!!!!	NOT
Prepare for the midterms by reading Creating the Declaration of Independence by  to understand what Made America Great in the First Place URL #MAGA #KAG      	NOT
 This is madness - This is when you know you are going down the same route as Venezuela!!! He is going to turn that sovereign fund into a personal piggy bank	NOT
 President Trump is keepinghis promises but this is the real reason he is hated. URL	OFF
"  Anybody who thinks its gun control"", needs to have a reality check on life."""	NOT
               (s)he is very affectionate and purrs non-stop.	NOT
 All we need now is a gang sign	NOT
  Forget Montel! Those who speak so speak from their own delusional disgusting truth! He is not worth it!  Trash pick up coming! URL	OFF
  You are way off	NOT
  I love the comments about squishy conservatives and their support of the need for guest workers. Sounds like  .	NOT
   #Feinstein needs to go. Her husband should be investigated for his #China deals and the Post Office deals. She is conflicted and this is below dignity	OFF
  take your fish and get out!	NOT
   ANTIFA: THE ANARCHIST WHO WANTS TO ABOLISH GOVERNMENT... BY JOINING IT URL	NOT
 It isn't so much that liberals are ignorant. It's just that they know so many things that aren't so.‚Äù  ‚Äï Ronald Reagan URL	OFF
" If you are running for re-election on the economy, you're in big trouble. There are 2 things that don't add up in your great economy"" pitch &gt; wage growth &amp; the deficit. In other words, you're screwed. Update your resume. #NovemberIsComing"""	NOT
    So the NDP and Liberals are the same because they are both left? They are two way different parties. For example NDP is way more Socialist than the Liberals and lean way more left.	NOT
#nowplaying WATER SLIDER by SHE IS SUMMER URL	NOT
     Just admit Manchester isn‚Äôt blue pal and everyone will be calm when you are the most successful club in the country let alone Manchester than we can talk	NOT
" That's very true Theresa. Most of those MPs however call themselves Conservatives"" oddly enough."""	OFF
 You are so dope man	OFF
  At a community meeting he did not answer the question about gun control. Just skirted around it!	NOT
 God help us if that happens	NOT
 üòÇüòÇüòÇ that he is	NOT
 You are.	NOT
 I guess people won‚Äôt be voting conservatives in the next provincial election üòÇ	NOT
 The Klan was the militant arm of the Democrat Party.  I haven‚Äôt seen a past member in public since Sen Byrd died.  Antifa is the new militant arm.	NOT
 Red Flags: She‚Äôs a ‚Äúprofessor‚Äù at a liberal school and she‚Äôs ‚Äúunable to have healthy relationships with men‚Äù. Translation: She‚Äôs an Antifa Dyke out to stop a Conservative Judge and President Trump even if she has to lie.	OFF
   Trump is done. You are a Anti-Ameican pro-Trump azz!!	OFF
     So conservatives NEVER get abortions? Were you alive when abortions were illegal? I hear it was a pretty awesome time in history.	NOT
 God bless you SIR	NOT
 Donald Trump in Nevada either at that MAGA rally or Tge GOP Convention...His Hollowing Out of America Tour or as Putin likes to put it...‚Äùproject red wave‚Äù	NOT
 Go after NRA if they allowed gun control this wouldn't happen.	OFF
 Liberals support this I thought.	NOT
"Antifa Ally  Yvette Felarca   Takes a Hit to the Head ""  Berkeley 8-5-18 URL via "	NOT
                   Here‚Äôs our response to  Antifa  Don‚Äôt you EVER ask our family for donations to #Antifa EVER AGAIN!!! URL	NOT
 It freaking sucks	NOT
  I think  is corrupt a back biter and a snake	NOT
"#Kavanaugh can't back out of nomination. He couldn't go back to #DCCircuit w/no repercussions. This charge will follow him. When Dems take back Congress, they WILL launch investigations. Conservatives who lie to get Judgeships will be impeached for high Crimes &amp; Misdemeanors"""""	OFF
   If any left leaning freak attacks me I will attack back. But so many conservatives are just compliant. Happy with just bitching and complaining. How can we fire people up. The left has got energy. Lots of it. And if things don‚Äôt change. We‚Äôre going to loose.	OFF
"   that was what was observed INITIALLY. any interest in covering how the opposite has occurred since then according to all research and that it ended up being a smart marketing strategy? better make another When ANTIFA attacks"" video as 3 college kids yell in a cafeteria instead."""	NOT
  But refugees! Marijuana! Peoplekind! Gun control!	OFF
...and said Kennedy was model of independent judge. The attack on Kavanaugh's character and integrity via 35-year-old accusations obscures his self-characterization as next Anthony Kennedy. There are no conservatives ( in the Senate.	NOT
  California is a state. In the USA. How stupid do you have to be to think there is gun control?	NOT
 Oh he is more than that lol	NOT
 How are those strict gun control laws working out for you Dems!	NOT
 He is so talented!	NOT
 I loved her since victorious. She was my first girl crush but when I first heard The Way I became a hardcore stan.	OFF
   I thought conservatives were the ones trying to rewrite history? ü§î URL	NOT
    He is great! Awesome songs... I love walk on by and what it is best!	NOT
 The 1965 immigration Act worked exactly how liberals hoped it would. Demographics are destiny.	NOT
   But under #Trump they agreed to take him back to Germany. So thank you  !!	NOT
 At least we now know why she is called princess toadstool	OFF
 By 'democracy' of course he means the Democrat party.	NOT
 YOU ARE TRULY a champion in every sense!! You win AND lose with grace!  you too are a champion!! Thanks for the terrific tournament!! URL	NOT
 Yes you are stalking. That's what a weirdo would do. If my tweets over video games hurt your feelings then go ahead and block me. Lol	OFF
Thank you   #MAGA #KAG #WalkAway URL	NOT
 bitch i saw your whole ass tweet from wednesday you bitches always talking shit then back pedaling lmao just admit it	OFF
  Because he is a liberal.	NOT
  He is a legendüòú	NOT
 Maybe your underlying theory is wrong.   There are a number of ways in which the nomination supports MAGA. Some of which Trump has hinted at.	NOT
 I'M ALMOST SHOT BY LA GANG MEMBER/ILLEGAL IN TRAFFIC 9/5/4.45 PM MY BELIEF IN THE 2ND AMENDMENT:REACHES ABSOLUTE:CRIMINALS WANT VICTIMS UNARMED:PIX LATER: NRA GUN CONTROL RIGHTS GRAB FALSE FLAG 2A #ICE POLSI FIENSTINE TRUMP	OFF
  They probably get bonus pay for that	NOT
 He is quite the yarn spinner	NOT
  It's too had liberals are exempt from laws.	NOT
  Not so bloodless for some  ... because ANTIFA...	NOT
   obama took away the constitution from us and that is a FACT..SANCTUARY STATES takes away OUR guarantied Protection from Invasion...Obamas BLM and ANTIFA that takes away OUR guarantied Protection from DOMESTIC VIOLENCE by the way all gun control laws come from Article 4 sec 4	NOT
 she is the only (semi?) important girl chara so ig thats who normie fans relate to? like also its teacher/student which is an obvious straight ship	NOT
" I hope you're also spending energy focusing on #antifa and the endless attacks on conservative citizens, cops, journalists, their destruction of property and the strange phenominon of journalists"" ignoring them?  Just kidding. Not like you're a real journalist/documentarian."""	NOT
  How about really healing the country by leaving it and taking the rest of the loony liberals with you	OFF
 this is the guy who put us on the original 100 antifa in C'Ville and signed it 'you're welcome'	NOT
 He is not qualified to be a politician and that is why I voted for him How can anyone believe the failing Democratic Party as all thier agenda is to discredit a successful President and economy Also here is the idiot that gave IRAN millions to support terrorist	OFF
" I doubt if he is afraid of France , but he is being hammered by the left here everyday.  We think it's France "" behind the genocide secretly for investments ? They sure are silent !!!  Not the ordinary French people , the global elites and banks .  My guess is you will get help"""	NOT
" Like all CONServatives,  lies. Either that or Druggy was stoned and not really present""."""	NOT
          Thank you Moe! üòÅüå™üå™  #MAGA  #TrumpTrainPortal URL	NOT
 Haha the devil himself. Now exposed could not wait any  longer to call for the wall not too be built.	NOT
&lt;treph&gt; I have my computer &lt;treph&gt; and &lt;treph&gt; no job. &lt;treph&gt; &gt; i &lt;treph&gt; You are carrying: &lt;treph&gt; a computer &lt;treph&gt; no job	NOT
  This is a big deal. Hatch has to be embarrassed. Oh yeah he is senile and can't find the bathroom by himself.	OFF
 So much for gun control...not to be incentive. But really. Just saying	NOT
 Thanks and you are a good looking young man and hopefully will find yourself a loving beautiful young man to love and love you.	NOT
 Good ..  she is the one that seems sexist	OFF
Trump Is Making America Great Again URL	NOT
  And this isn‚Äôt considered hate speech for the liberals.  If a republican said that about democrats the MSM would be raising 10 kinds of Hell   The hypocrisy is to be expected now	OFF
* lives in Chicago   * thinks gun control works  üòÇüòÇüòÇüòÇüò≠ URL	OFF
 We love you Mr President! Miss you more then any other President that has been in office. You are a class act my friend. üôÇüòô	NOT
 Meanwhile media on ANTIFA... URL	NOT
   So the only difference affecting crime rates between HI and CONUS is gun control?	NOT
But but #Beeto has the Drunk Drivers Who Leave The Scene Of An Accident vote all sewed up! #MAGA  #TxSen URL	OFF
  Liberals never apologize	NOT
 A disgrace...	NOT
  She's probably a millionaire now and once they get paid all that money to slander and ruin someones name they go away because they don't want to get sued  for slander/libel. The Democrat Party pays a lot of money to get people to make false accusations against conservatives.	OFF
 BO is bitterly PO‚Äôd that Donald Trumps presidency has made him look like the bad president that he was.	NOT
  All 20 of them!  Hardly a problem until the Antifa of hundreds showed up .... for what!   To riot and destroy!!!	OFF
 Wish to suck angel cookie....	NOT
 dallon you just said lit i'm sorry sweetie but you are cancelled	NOT
 ‚ÄúYes. No one should make threats.‚Äù Really? What happens with  and her call for assassination of  ? Of #antifa Or the great damage done on inauguration day. Or Parkland &lt;&lt; trained by Obama policies. Or Scalise near ‚Äúhit?‚Äù Go home Swalwell	NOT
What the democrats refuse to understand about freedom...is that there are several sides to every situation! Understanding  and intellectual reason! U can‚Äôt survive in todays society in a one sided ... Fake...life! Truth will set us free! MAGAüá∫üá∏üëçüèΩ URL	NOT
 Fuck my bad leslie i def added you tho ! Lmao im give it to ypu now	OFF
    And you say liberals make false promises? How‚Äôs that wall coming? How‚Äôs that denuclearization of NK coming? How that ‚Äútax break‚Äù working out for you? Nice ole tariffs we got there huh? But yea keep on saying wild outlandish shit to make you feel better	NOT
  sexual assault should disqualify a nomination. ask yourself this why didn't they ask him any questions about this in private or public hearing. the accuser had posting on Facebook about stopping conservatives and trump. why do dems still trot out bill  clinton	NOT
  ANTIFA feet.	NOT
  Absolutely love Serena....however - the way she behaved was totally on her and the ref was within his rights...she is deflecting here by making it about women‚Äôs rights....	NOT
" Trust me.. i know her well enough so that she is ok if i take a body of another good girl for the night."""""	NOT
"#Republicans morals are stronger than #Democrat #Liberals  Evidenced by trying to stop Liberals from aborting themselves out of existence  It's the right thing to do   Even though letting them kill off their young so Natural Selection would win would benefit us more  #MAGA #KAG"""	OFF
"91.3FM The Edge is playing What You Are"" by Audioslave."""	NOT
*shuving tide pods in mouth* need more gun control nomnom nom nom	NOT
 Every one of them is more rank than she is. And she's pretty rank. So I guess they all outrank her...	NOT
  some people are talking crap about serena questioning her maturerity and justifications of her action. If you never get burn before you will not know how it feels to get burn Serena knows   it she has seen it. She is tired of so she is speaking out and it is an issue.	NOT
 come eat me ü§§üòçüçΩüòñ	OFF
    Antifa is banned by the central commitee for they are not proper socialists. More pinko then red.	NOT
  His staffers should remember that Trump is in favor of using enhanced interrogation techniques.	NOT
 Just make sure you have another one to March out there when this one gets laughed at ok? Think ahead liberals   Or should we just back off because she's a female?	NOT
 And the only people who actually watch the Emmys are low intellect liberals and crackheads.	NOT
            They will try don‚Äôt want attention on released FISA documents	NOT
  He is such an A-Hole. Sad.	OFF
#Police Pay rise 1%   #CrisisInPolicing #PolicingInCollapse #Tories &amp; #TheresaMay hatred of Police!  #lbc URL	NOT
  But Google can give Beijing every Americans phone number. You‚Äôre kidding me right?   MAGA 2020	NOT
 Combined IQ= -6	NOT
   She is a walking talking lie..  that‚Äôs why.	OFF
      You are the racist. Serenas outburst and pure hate was the worst I've seen in tennis	NOT
 -Yogi Bear -Nick &amp; Nickelodeon -FoodNetwork -HGTV -Ancient Aliens -Hallmark Channel  Next channel to surpass CNN in ratings: ESPN	NOT
 Stop saying this shit you are not going to do it shrio you have to fight this depression you can't let it take you half of my life was me hiding my emotions everyone thought I was happy but deep down I wanted to end it all but I didn't let depression beat me I kept fighting.	OFF
  Because CHEAT if you have to!  Just WIN at any cost is the new  motto.      And MAGA &amp; shit.‚úä	NOT
Energy Independence: A 'bi-product' of Donald Trump's relentless pursuit to #MAGA! URL	NOT
  lmao @ the WORLD league viewership compared to league of legends or overwatch or cs:go. Main issues are that the format is shit and the game is on console. So you need to fix one of them. Console could be turned into an advantage uf u capture the attention of Joe Shmo	OFF
  Since we are a republic.....no. #MAGA	NOT
 Google and Twitter are monopolies. They need to be broken up by the government.	NOT
 about as high as he is	NOT
                                                 Now do Black Lives Matter and Antifa.	NOT
 You are the worst	OFF
    This is because Japan have a PM with COMMON SENSE &amp; FORESIGHT. They do not pander to Muslims like MAY does. TORY POLITICAL SUICIDE - G.E. 2020 üòÑ URL  ex TORY	OFF
  In the criminal world of the democrats &amp; liberals this is exactly how it works!!	OFF
      She has no credibility. Lives in a $4 million mansion and associates with Antifa. Who would stab her in the back anyway.	NOT
 I'm wondering how he is going to keep those leaves on	NOT
 Get away from these lying toxic people!	OFF
 I bet she thinks you liberals abused here when you told her it was just an op ed not a photo shoot.	NOT
"       This women is a vile example of the far left lunacy. She is using the Alinsky, Rules for Radicals Handbook."" No matter what u have to do, (lie,steal,use violence etc. )u must destroy the conservatives. They lack character &amp; have no moral code."""	OFF
   They should consider gang squad units. They should consider controlling the dope epidemic. They should consider a lot of things. But the loosing left would disagree and just scream gun control	OFF
  You said gun safety laws. Funny. You mean gun control agenda.  Your staffers must be editing your shit these days. Kudos to the minions.	NOT
 Because they‚Äôre so hateful and can‚Äôt cover anything except Trump.  I remember when Wolf and Anderson were actually decent journalists.....	NOT
   has a deal with samrat family i think to save him from the case. We know how samrat is attract for girls teju and geetha. Now when complaint came he is taking care. Sad for her wife #KaushalArmy #BiggBossTelugu2	NOT
  Got some antifa stories to share?  I'm interested.	NOT
"Dear Liberal #FakeNewsMedia This gesture you call a white power"" gesture is actually what we NORMAL people call the ""OK"" gesture.  I realize this is not as fun as your make believe ""white power"" name but yeah. That's what it means.  OK ? OK! #WalkAway #MAGA URL"	OFF
  She is the cutest baby I have ever seen	NOT
 His back hole will look like the holland tunnel we he gets to the male prison	OFF
  Hmmm. Was NFL on tv today? Didn‚Äôt even search. Watched tennis &amp; baseball. Not one of them kneeled! Won‚Äôt be watching next week either.	NOT
 Evil	NOT
 #Trump gifted the 1% with #GOPTaxScam the biggest wealth grab in modern history URL yet #trump supporter #dopes prefer to vote against their best interests so perhaps you cannot fix stupid!  #MAGAüá∫üá∏	OFF
 Eric maybe jail for you.	NOT
 He is the gawdfather of #fuxNews  URL	NOT
   I think he is right behind Trump.	NOT
 can we start shooting the blue thugs? then going through their shit and saying thats why they died? cuz this is fucking infuriating. WTF does it matter there is pot in his home. WHAT is in HER home?! SHE is the guilty one not HIM.	OFF
  your disrespect for those that make real sacrifices to defend our freedom is appalling.   is a punk.	OFF
   They‚Äôll never get enough Antifa who even know where the library is...I think we can relax üòä	NOT
 We conservatives love him no matter how stupid it makes us /him look! YEE HAW! URL	OFF
 Cause you sweet lil nigga	OFF
 Unless you are  your knee will not be the same	NOT
All Trump's and Pense 2020 merch is being made is China and not the USA.    ...maga ??   #VoteThemOut2018  #TrumpsArmy URL	OFF
 he probably gets paid to say that...with $$ and assurances that he won't be called an islamophobe---pfffft it's a fake word--justin is an IDIOT and he is destroying canada one refugee at a time	OFF
 Will antifa fill the streets when kavanaugh is confirmed	NOT
 Turn them loose and see what happens to her city. People like her is what gives the Democrats a bad name. She is risking the entire population of Atlanta. Wonder how the citizens like it. We‚Äôll see at the ballot box	OFF
    You knowmandni know you are on the verge from my education satochi data	NOT
 He is very scared that he will loose...... Yay!	NOT
"    Jonathan Haidt's The Righteous Mind"" should be required reading in high school.  Parts of the book elucidate exactly the problem conservatives like Shapiro contend with: they think everyone thinks/acts like they believe they do - making choices rationally and on principle."""	NOT
 bITCHC IM UWUING	OFF
  Why do liberals shout and hang their mouths open? Slack jaws.	NOT
   The deception and dirty tricks happened when  refused protocol and stole a SCOTUS seat from Obama.  Conservatives love to fight dirty but then cry foul when others call them on it or play hardball right back at them.  Bunch of pussies.  #MerrickGarland  #Resist	OFF
  You are devaluing everyone's opinion on the Independent article whom agrees with me by saying they are disgruntled students or bots. Just because they don't put Dr. In their Twitter name it doesn't mean they haven't done 'deeply important research' as you fondly put it.	OFF
  after which she is thrown under the train...	NOT
 I know they be fired up thinking u got a hammer n your pants from how u walk n find out u got a coochie lol	OFF
 This is what desperate liberals look like. #SpyGate #ObamaGate	NOT
 Can't a man call his dog without some old bat bitching about it ?   	NOT
" Anne Coulter. Oh, and Jack Abramoff. You kids were stupid enough to be courted by Conservatives"" when they showed up on U.S. campuses, back in '80.   So, there's two..."""	OFF
#Tories #Labour #GE2017 #Conservatives Conservatives URL theresa_may: Since my very first day in 10DowningStreet I‚Äôve made it my personal mission to fix our broken housing system. Doing so underpins so much of what this Government is‚Ä¶ URL	NOT
 Lovely intelligent girl who knows what she is doing at such a young age	NOT
   if you're hosting them you are AT LEAST nominating them for a prize! Don't be teasers!	NOT
 FOR THE KOCHS AND THE TRUMPS AND THE POLLUTORS.. BUT NOT FOR WE THE PEOPLE OR STUDENTS OR TEACHERS AND LETS NOT EVEN TALK ABOUT THE THINGS THAT A MAJORITY OF THE AMERICAN PEOPLE EXPECT LIKE HEALTHCARE &amp; GUN CONTROL! NOTHING BUT $$ FOR  AND DONORS!	OFF
 Carter was the worst one term President until h was passed for that title by Oba our first Black Racist President!  Kinda like  a Black Jefferson Davis!	OFF
    What‚Äôs the difference between Antifa and the brown shirts? Nothing URL	NOT
" Tom Marvollo Riddle. Evan will lose his dick if he fucks around he knows it. Cause he is already after a lady""  She nods and looked at Evan.  Evan grins at her and stayed silent.  He did liked to fuck around but he knew he could not hurt his date"""	OFF
  Wow! YOU'RE exactly like ANTIFA! You say you're against radical influences but YOU are THE MOST RADICAL OF ALL! De-platforming anyone that disagrees with you? Did you pull that one straight out of Hitler's playbook? Can you get any more Nazi Fascist? LOOK BEHIND YOU! IT'S KARMA!	OFF
   Please can I have some of whatever it is you‚Äôve been smoking?  Thats some top quality shit you‚Äôre coming out with.	OFF
  Rodenbury was against violence and would have advocated for gun control.	NOT
1. Have we thought about Gun Control in Uganda?  2. Do we have  records of most of the guns in the country?  3. Do we have laws controlling our borders?  4. Who is safe?	NOT
 I like the way she shows her emotions... She is really a Queen of Hearts....  ...Love you	NOT
     so it is ok for Congress to take away the Constitution like they did?     you realize Congress just took away all gun control laws when they threw out Article 4 Sec 4 US Constitution....  ALL gun control laws come from there	NOT
 BLAME TRUMP?? That‚Äôs sad to the good people of Puerto Rico üáµüá∑	NOT
 BOYCOTTING the National Fools League URL	NOT
 #NeverWithdraw  !! #DianeFeinstein waited on #ChristineFord lies because Dems needed time to scrub the vast amount of Ford's anti-Trump social media rants and coach her  to keep her story consistent.   #Democrats and #Liberals are evil and mentally sick #ConfirmKavanaugh	NOT
 You are so fragile. It must be hard to live that way.	NOT
   Another domestic violence crime. Welcome to California.  One of the most violent states with surprisingly high amounts of gun CONTROL laws... too bad tbose people do not have the legal ability to defend themselves.	NOT
 Leave it to CBC to turn a bad story for the libs into a critical piece on the conservatives	NOT
 He‚Äôs a disgrace to his party and all he claims to stand for. He‚Äôs not on the side of conservatives. He just wants to make a name for himself and anybody‚Äôs cost.	OFF
"      You are fkn deluded pal #FatNixon is a digusting pig  Trump interview on 9/11: [My building] was the 2nd-tallest in Manhattan... And now it‚Äôs the tallest."""""	OFF
 Don't know who he is and don't really care...	NOT
 You are welcome dear üòáüòá but for what? URL	NOT
  As I‚Äôm sure he is advising everyone must evacuate üôÑ	NOT
 I understand how regulations work. Do you understand government can‚Äôt control everything. Do you understand most of those regulations stopped business growth. Trump isn‚Äôt Politically correct i get that. But he is doing what‚Äôs right for America.	NOT
4 UK/US DEEPSTATE NUKES INTERCEPTED HEADING FOR US CITIES. #skynews #skypapers #bbcdp #lbc #lbclive #talkradio   #altnews #brexit #remain #london #cityoflondon #news #breakingnews #uknews #labour #tories #trump #toryparty #ukip #conservatives #christians #qanon URL	NOT
  interesting. Now do you and your state of Illinois. ü§°	NOT
#REALITY_CHECK for #CPC Conservatives - from Ninja Warriorüëπ#Heather_Mallick.  Opinion | CPC beware ‚Äî meet Maxime Bernier‚Äôs new hard-right PP URL via 	NOT
 Mon ¬´¬†bye bitches¬†¬ª suffisait	OFF
  The last thing parents need to learn from the liberals is the ethics of raising their own child.	NOT
  And the NRA supported gun control when it was targeting the black panthers who were defending black neighbourhoods against police brutality.	OFF
 That's not Southern California.  It is considered Central California. Great how our gun control laws work here isn't it?	NOT
 I do i do buh if u really know me you would know Khabib is my guyyyy. He is gonna make him humble	NOT
 Can somebody get a cry room for her?	NOT
"  You said that conservatives who passionately complained about deficits are now driving this speeding dump truck"". Now suddenly ""R's"" are the subject? That's what I thought. Conservatives were complaining about the ""Rs"" as well"""	NOT
     He is Crying In his Pic or Tum Hs rhi ho üò°üò°	NOT
 Trudeau claiming what conservatives did or didn't do instead of what he was to busy to do for the last 3 years #TrudeauMustGo #liberalsmustgo #GoneIn2019	NOT
 Any time liberals think their going to get a win they tune into their head cheerleader. Then they realize the latest bombshell is once again nothing and go back to their miserable existence eating chunky monkey (not racist) and watching Netflix	OFF
   Says the fat Antifa member	OFF
#paytoplay Her Gofundme is over $200K Liberals are society‚Äôs bottom feeders. #freakyford URL	OFF
 UR SO FUCKIDNG PRETTY PERHAPS I SHED TEARS URL	OFF
Meet Walter: Walter is most likely #Maga.Walter believes the lies he told daily about an imaginary #WalkAway being talked about in no community of color because it is #fakeNews.Walter does not understand minorities penchant for remembering what u did to them..Walter eats toenails URL	OFF
  with this useless try hard comedian love preaching hate about  They have so much hate in them for a guy they loved before he was president. Maybe infatuated with the guy. She must dream about him.	NOT
  She says she wakes up from sleep thinkin she is gonna get Trump.   She needs a Psychiatrist! ASAP	OFF
Mueller proves the judicial system is weaponized.  Democrat special councils only charge Republicans.  So if we play the game then Republican special councils should charge Democrats.  Right!   Balls in your court Republicans.   MAGA URL	OFF
 Another ‚Äúperfect‚Äù teacher!!!	NOT
               not what the conclusions says in the paper. do you know what experiments they did? you are just like an creationist that blindly believe what the news says. You are like an catholic that beliees every word of the pope.	NOT
          Sexist...could be a crazy gentlewoman #LuLz	NOT
"  Awesome! Every antifa should go through this Initiation""üòú"""	NOT
" So tired of the spicy I know the far right includes literal murderers and far right terrorism is on the rise, but antifa are just as bad because I think they broke a window once."""""	NOT
 she is the cutest ever!!! üò≠üò≠ thank you honey!!!	NOT
 Basically what she is saying is someone wanted to float an accusation without facing any legal or civil accountability for it when it turns out to be BS. This is beyond unethical.	NOT
                Following you anyway.	NOT
  Good luck ü§£  #MAGA #VoteRed URL	NOT
5.0 Star Review on SocialSurvey ‚Äî Cristyn made my buying experience so easy and enjoyable! She is amazing!  by Lindsay P. for Cristyn Dyess URL URL	NOT
#LeviStrauss takes stand on gun control #SanFrancisco #LEVISTRAUSS&amp;COMPANY #America #SaferTomorrowFund URL URL	NOT
 Guess you are going to ignore what karmys are asking...  üíÄüíÄüíÄ	NOT
 Antifa simply wants us to kill them. By the way. Most of us carry a back up. And a knife	OFF
 Guilt by association i see. A great tactic by spineless anti-white liberals.	NOT
            Why to the cowards not list ANTIFA on their profiles. Cowards or terrorist or both... I‚Äôll go with both!	OFF
  You have a legit 30% socialist bloc in Maryland.  That will win a crowded primary but overall most people don‚Äôt want to go that far left.  As a Baltimore resident that‚Äôs what liberals(who is mostly everyone) say.	NOT
 Antifa girl of the month centrefold!	NOT
  She‚Äôs a class act isn‚Äôt she. Kim the 2nd	NOT
 Shocking almost all liberals are crazy and insane since that Clinton witch lost they‚Äôve become #unhinged #deranged  and a bunch of damn #crybabies stop acting like children and grow up	OFF
#QAnon #GreatAwakening  Awake Yet?? It was a setup from the beginning... and most liberals know it..   they just don't have the morals to accept it!!  URL	NOT
"  Well, see, if I start talking at Dana about sensible gun control laws and she ignores me (or calls me a tragedy dry-humping whore"" as she did  then we aren't having a conversation. I'm just talking into the void."""	OFF
   Here your proof!  Our African üá∫üá∏ friends don't get free college.  The Demoncratic are putting illegals over üá∫üá∏ ppl. These Antifa Ninja Turtles running around acting like jihadist and never lived a real life experience. Most of these Antifa colleges kids are White privileged	OFF
 Qual? URL	OFF
 I see boobs lol üòÇüòúüòòüòá	OFF
  ..........kindergarten for adults???	NOT
  I think Collins has maybe seen the light given the threats against her from Liberals lately.	NOT
" You are more than your productivity""?"""	NOT
 Actually it‚Äôs only libs that ACTUALLY follow up on their threats  36 cops murdered so far by libs 100s of cops shot by libs Dozens of republican congressman attempted murder by libs Antifa assaulting on behalf of libs  URL	NOT
 Excommunicate the guy. That‚Äôll teach ‚ÄòEm.	OFF
" Heavenly Father I ask for a hedge of protection for those in the path of this horrendous storm. May God Bless the USA, the POTUS and the Patriots of this Great Nation! May God's Wrath fall upon all Tyrants, Human Traffickers and those who betray our Great Nation! WWG1WGA"""""	NOT
Actually nvm DC animated films are the shit	OFF
 Eric Smolder Ex Atty Genl. Epitome of the Labamba govt. sheister.	NOT
  I remember you. My sister told me what you did to her. You are lucky she didn't call the police.	NOT
 What about ANTIFA? No one would have died if ANTIFA hadn‚Äôt showed up without a permit	NOT
 Denial stage. Almost at admission	NOT
 . is like railroad tracks - laid across the country	NOT
     Antifa came out of the old German Communist Party 1932. Just history. That's why they wear masks. URL	NOT
 I hope you are at the park.  They are playing rush	NOT
      She is being realistic tho URL	NOT
  Insanity...just like the commies! #hypocrisy #TheStorm #maga #KAG #QAnon URL	NOT
  Then why the fuck did they elect him	OFF
 this is BULLSHIT! Some crappy pop star in Philly instead of the Fresh Prince &amp; DJ Jazzy Jeff! All of America needs to take a knee over this	OFF
 EAT MY ASS OH MY GOD YOU BETTER BE LYING	OFF
   Every day her IQ gets lower and lower more wanna be nazi Barbie is going to be a pile of maga goo on the bottom of the set soon enough .	OFF
" Did she also say when they do to walk away""?"""	NOT
 Can‚Äôt rehabilitate a pervert zero tolerance So disappointed in this pope	OFF
 6.5 Billion Human Beings are spare to capacity according to the One World Government End Game Agenda ~ that 6.5 Billion includes 1.5 BILLION Muslims ~ #MAGA ought'a keep that in both heart &amp; mind ~ #ReligiousFreedom #Republic #FreedomAndJusticeForALL ~	NOT
 He is spending your contributions. Vote Ted Cruz!!!!	NOT
 Reason number 865 why conservatives don‚Äôt do comedy.	NOT
 Zimmerman belongs in prison for killing Travon Martin.  Florida needs to change its gun control laws.	OFF
" Liberals sure love to spend other people's money !!!!!!  Hope and change""  really works well for the Obamas who are multi millionaires.  Their fortunes have really changed for the better !!!!!!  If liberals have any brain cells left, they'd vote for President Trump !"""	OFF
 They know this is not admissible so they are attempting to contaminate the jury. They are working overtime to ensure she is found not guilty...	NOT
This y‚Äôall king? #maga URL	NOT
       Far-right attacks and plots FAR outnumber antifa counterprotests and attacks. This is documented.	NOT
 He is most impressive at corruption and lies.	OFF
  Far left Antifa just a bunch of bullies who get brave when in a mob confronting a few  seems everyone is a nazi if they have a different opinion	OFF
 Because Obama has zero accomplishments. He is the worst President r leader of any country hands down. It shows the liberal lunacy when they worship a total loser. They don't know what they want..no party goals. nothing except complain about TRUMPS accomplishments. Fu*k liberals.	OFF
                               I think you are being abnormal	OFF
 Your husband is a despicable person.  He is a narcissist who cares about no one - including you- but himself.	OFF
"    Antifa are the fascists.  But, since you have been indoctrinated, you probably don't even know what fascism actually is.  Antifa are not fighting neo-Nazis"".  They are fighting anyone who isn't them, and they call them Nazis just to justify their hate."""	NOT
  Not one of these ‚Äújournalists‚Äù mentioned the arrest of the corrupt mayor yesterday. I guess they were busy not getting blown away in the wind	OFF
 People who fail to understand the Second Amendment's purpose is to protect a citizenry from a government takeover SHOULD NOT be talking about gun control	NOT
 nigga bouta go direct traffic w style	NOT
 Good.  He's a mess	OFF
    Using that thought/conspiracy then it would be safe to argue that the liberals have concocted this and are stalling in order to help the liberals interest in that. The perfect pawn would play fearful of  the process thereby helping confuse &amp; prolong the process.	OFF
#ReleaseTheCures #DeclassifyFISA üá∫üá∏ #ItsTime #LockThemAllUp #WWG1WGA üá∫üá∏ #GreatAwakening  #Winning #QAnon #MAGA Guess Who! URL #BitChute	NOT
  According to the liberals yes!  Guilty unless she proves her innocence!  Wait are you a man? If so then No you can not be trusted ever! How dare you make a claim against a woman! Women are above the sins of man!  We are perfect!	OFF
  pathetic	OFF
 She is so frickin adorable	NOT
  Why is this crook walking free?	OFF
 Wow you are actually terrible. Imagine being proud of getting people in a disaster zone finding water arrested.   The store owner didn't want them arrested and you are an awful person.	OFF
 Russia had Ivan the Terrible. FSU has Willie the Terrible. He is to FSU what Bitch Rod was to Michigan and Tango Charlie was to Texas. We pay this piece of shit $5 million to put up 10 points against our first two FBS opponents. Even Western Michigan scores 41 against Syracuse.	OFF
      The fine people he was referring to were the military vets &amp; others who had a legal permit to protest the removal of a historical statue. That isn‚Äôt good enough? By your standards the counter protesters were all Antifa.	NOT
   Hahah can you ask her do the same with other books bible or quran??? Then you will see.. May be she is part of urban naxal	NOT
 Twitter is becoming tumblr 2013 and I am fucking terrified	OFF
 If gun control worked Chicago would be a safe place to live	NOT
 your heart is beautiful Your interior is wonderful. You are wonderful‚ù§Ô∏è‚ù§Ô∏è‚ù§Ô∏è‚ù§Ô∏èüß°üß°üíúüíúüåπüåπüåπüåπüåπüí•‚ú®‚ú®‚ú®‚≠êÔ∏è‚≠êÔ∏è	NOT
 I wish liberals would keep their promises	NOT
 Feinstein's gun control policies would deliver even more school shooting victims.	NOT
"   You prove how little you know about history, with each new post, wep. Wars are the failure of diplomacy, enabled by an arms industry feeding off taxpayers. Gun control"" is the last thing on their mind. You've been lied to, by pros in the pay of gun manufacturers."""	NOT
                                  Nice list. Of course I am against gun control. I am also in favor of freedom of religion. People can believe whatever horseshit they like. They just need to keep it out of schools. Creationism has no place in schools.	NOT
 you are all recycling of liars	OFF
Active shooter Middleton WI several ambulances üöë on stand by waiting for police to clear building #MAGA #TrumpTrain   #KeepAmericaGreat2020 	NOT
. You should totally follow those whack job liberals...unhinged and dangerous! Thank you üá∫üá∏	OFF
  I am talking about Brett. He is the one that is in trouble if he doesn't win and make a big move	NOT
 Whenever ya'll reference the wire all I'm going to think is exit stage left	NOT
  Dude why do you want #DeepState documents to be kept secret? #MAGA  #LockThemUp	NOT
    He forgot to tell you that during slavery the Democrats were conservatives	NOT
 War on conservatism: #Antifa	NOT
 You got this. Whatever the problem you are strong enough to overcome it. It gets easier everyday.	NOT
  Now Comes The Pain...............  #MAGAüá∫üá∏üá∫üá∏üá∫üá∏üá∫üá∏üá∫üá∏  #WWG1WGA URL	OFF
 who in America isn't grateful to our military?!?!? Her husband didn't die on the battle field...he died at home!! She should be fighting for gun control and stronger laws regarding mental illness!  is about police brutality...she should educate herself on the issues	OFF
     She and Him beign a Joint Acct. Have called Me and Grok everything under the sun  The Same Person Women Racist Redneck Antifa  KKK Members Grannies (Yes Grannies) Haha Etc  It's pretty common when the Fraud Gets Busted to start calling the one's who Busted them hilarious names	OFF
  U a dickhead for thatüòÇ	OFF
 The Democrats don't care. They will do anything to undermine President Trump. People had better realize how serious they are about getting rid of him. Vote Red or suffer under the liberals.	OFF
 A lot of people in America have serious concerns about the amount of lying you and your ilk are doing	NOT
       Ok lang admin we understand. Praying that you overcome whatever problems or hardships you are into right now through our Lord Jesus Christ. #FrancisAglabtin2TulogNaLang	NOT
  Gun safety reform? What exactly does that mean? Do you mean gun control?	NOT
 You are being super cute with your hormone story's and I hope all 3 of you are well	NOT
 You are no longer relevant Bob. Shut it down. Have a great retirement.	NOT
  Oh no!! That sucks üò≠ what if you are ‚Äúsick‚Äù ü§Æü§¢	OFF
 He was either looking to pray or for prey.  ü§™	NOT
  So Kerry thinx bcuz an anti  leftist narrative has bin spread+ 'heard' by everyone in Washington that it qualifies it as.......Fact?Thats not how facts work u dumb leftist!Thats called an intentional smear spread to create a lie to use as a talking point for desperate Dems	NOT
Shop URL   #80s #BREAKING #FORTNITEANDROID #kungfu #fantasy #movies #Trump #maga #80s #tech #texas #trending #SundayMotivation #maga #gop #GameofThrones #beard #men #news #BREAKING #kungfu #shop #shoponline #TXSen #texas URL	NOT
 He is in jail	NOT
   cares a great deal about how he is perceived. The number of people who died is largely irrelevant to him as long as he doesn't look bad. Not sure how blaming Democrats fits with Trump's amorality and lack of empathy but his inability to take responsibility fits.	OFF
  He worries about ‚Äúantifa‚Äù while he invites and poses for pics with known neonazis. SMDH	OFF
  No but it is relevant in showing that gun control laws DO work. The number of deaths via mass shooting went down in the US between 1994-2004 during the Assault Weapons Ban	NOT
                                            The other is the symbol of pedos as confirmed by the FBI URL	NOT
  Antifa is much much smaller than white supremacists in America and responsible for a fraction of the violence. Also NAZI'S ARE BAD!!!	OFF
  Too bad he can‚Äôt write a law to take away the stupidity from liberals.	OFF
"...[bring] our railways back into public ownership, as franchises expire or, in other cases, with franchise reviews or break clauses. We will introduce a Public Ownership of the Railways Bill to repeal the Railways Act 1993 under which the Conservatives privatised our railways."""""	NOT
 This is an outstanding thread and expert insight- ESP about the Reagan years which I studied in college. He is spot on and there was such a titanic shift begins in the 90s with rhe Contract with America bs to the immigration issues in CA (prop 187)	NOT
 This liberal is pissed that anyone would give that disgusting pos an award for equality. And....f.u. for including all liberals in this bullshit decision by the HRC.	OFF
 Another sick liberal ü§≠	OFF
  Thanks David. Was always helpful and inspiring when I was a student. He is greatly missed.	NOT
Keep your mind open. #conservatives #republican #MAGA #Shadowbanning #AmericaFirst #Trump #Patriot        #WalkAway #WalkAwayFromDemocrats #FakeNews       URL	NOT
 Aw. He is so sweet. Sharing food is significant. How rude. Did they eat well? No!	NOT
   The historic moniker for the Tories is The Stupid Party.   American conservatives test out with lower average intelligence than liberals.	NOT
 If you stand up for what's right? The Conservatives were mad one of there's crossed but it's ok for a Liberal. That's double faced!	NOT
 ACLU is insane. The antifa democrats are violent and should be declared a domestic terrorist group.	OFF
 Any mention of using the 25th Amendment on obama would have had the left screaming racism.	NOT
  they couldn't elect her the first time '08 yet we were supposed to pick up their leftovers in '16	NOT
 Shame on them willing to ruin good man over a 36-year-old groping accusation she can't prove.  They're rabid liberals who don't want a Supreme Court justice who will follow the Constitution.  It's all about politics.  Shame.	OFF
  BTW - Guns are inanimate objects ... it is the evil soul behind it that pulls the trigger.    URL	NOT
 6 million dollars for 2 years left on a contract?   WTH was she really doing there?	NOT
 Tbh if you‚Äôre doing international adoption you‚Äôre pretty much buying a child ü§∑üèø‚Äç‚ôÄÔ∏è. People do spend a lot adopting children bc our system allows people to baby broker for profit. In America if you‚Äôre going through an agency you are in part buying a child	NOT
  He has been on the take...Ukranian money...he is dirty	NOT
 {| That's okay!	NOT
 Go roger I quit watching anyway nfl is on the way down the people are moving kids to soccer golf tennis shame but kneelers are killing the game	NOT
  Sorry but antifascists and left leaning people need guns for defence unlike what some liberal pundits are propagating with their gun abolition rhetoric. I used to support gun control but I don‚Äôt trust leaving the state to have even more power over the majority worker class. Also	NOT
   Soy boy is a slur against liberals. I wasn‚Äôt calling you anything.	NOT
 He'll be replaced. . . . . . . . by another Muslim.	NOT
 Just plain stupid she thinks she‚Äôs being clever but come the next GE the public will make the Tories pay by casting them into the political dustbin for yrs to come see how smug she is then	OFF
 Hold the damn vote. Iowa voter chiming I‚Äôm here. Wuit the damn Liberals game and stand up to this crap.	NOT
             Very very proud of Flotus	NOT
" skating is WAY better than before. Visually it doesn't looks a ton better, but it runs smoother and crisper"" for lack of a better word. I'm curious how 17 and 18 feel now if I revisit them"""	NOT
    Think about why the NDP one it's because people are sick and tired of how conservatives run government and the UCP was supposed to be a different type of conservative but it's not	NOT
 you are like a real life cartoon character!! I love and respect the shit out of you for it. Keep doing you	OFF
" Please don't confuse Liberal"" with ""progressive"".   We are all liberals at heart. We don't force our beliefs on others.   The same cannot be said for lefty progressives."""	NOT
 She is a biggest Thing she as fail everywhere else	OFF
 Gonna boo his ass regardless now	OFF
  It‚Äôs easier for Pod to believe both sides are terrible. Then he doesn‚Äôt have to honestly look at the conservatives.	OFF
  Why do all you liberals insist on trying to control everyone in America? Why do you insist those of us that work hard for our money have to give it to people who don't? Why do all you liberal millionaires keep your millions while forcing me to give away every dime I make?	NOT
  GUN CONTROL SUPPORT IS HIS DOWNFALL.	NOT
 By arguing a call? The media and you are making it a big deal	NOT
  LMFAO!!!!	NOT
Soooooounds like an AWESOME plan !!!  Next he‚Äôs gonna be pulling money from Medi-care &amp; Pensions to pay for all the Golf Cart Rentals for his  detail that watches him struggle to stay on the fairways on all the Golf Weekends he swore ‚Äúhe‚Äôd NEVER have time for‚Äù #MAGA URL	OFF
  You know what wasn‚Äôt in his apartment after? Him. And that‚Äôs the fucking problem.	OFF
 A MASSIVE TOOL	NOT
  YOU ARE SO PRETTY OH MY GOODNESS	NOT
 So Glad Your Back üôè Hygs Love You ‚ù§ Getting Ready To Do A  #ProLife. Presentation #Maga  #üíØüá∫üá∏üá∫üá∏üá∫üá∏ URL	NOT
  He is complicit in the abuse of young men. Why would he care about a woman. He make me sick.	NOT
  That's exactly what he is....	NOT
          The World Wide Phenomenon of Podcasting and MVP of ShitTalking!	NOT
        He IS GOING PLACES!!!!	NOT
 This stinks like week old fish she is a best a liar	NOT
@ MY LRT IM DYDINV G SHE IS BEAUTIFUL	NOT
  You are a bright star for Texas.	NOT
  You are the man!!!!!	NOT
 Take a vacation!  #WWG1WGA  #MAGA	NOT
20 Crazy Things Liberals Blame Trump For URL via   Unhinged blame everything on our President.	OFF
 She is a cutie!!But she needs a PACKER bib	NOT
  What really pisses me off about Asians in California voting for more gun control is that many should know better especially Koreans in LA. They all knew someone who had their businesses destroyed during the riots. At least this salty boi hasn‚Äôt forgotten: URL	NOT
 You will not win. Texas doesn‚Äôt need a liberal. Everything liberals touch turns to crap!!	OFF
 Looks like #antifa to me....just saying. URL	NOT
  Hi Bernice üòä I hope you are enjoying the #xrpcommunity and learning lots about #xrp üòÅ +.0589  üí´üí•üòò	NOT
        Right I'm stopping replying to anymore of your nonsense but going to keep following you to warm others of your dangerous take on society - you pal are the biggest fake going and been proved and just like all the rest of antifa are bloody dangerous	OFF
  I‚Äôm afraid you are right.	NOT
  Repeat after me zombies...	NOT
"Adicionei um v√≠deo a uma playlist  URL LIL PEEP Type Beat You're Leaving Already"" | Melancholic"""	NOT
